Date,Minf2,Pip2,Msup2,Trend2,Tail2,Minf1,Pip1,Psup1,Trend1,Tail1,Out,High1,Low1,High2,Low2,Open1,Close1,slTmp,tpTmp
2017.12.28,1,557,167,Up,725,60,623,210,up,893,pert,120255,119362,119589,118864,119422,120045,833,60
2017.12.29,60,623,210,Up,893,81,491,233,up,805,pert,120812,120007,120255,119362,120088,120579,724,81
2018.01.02,81,491,233,Up,805,132,437,82,down,651,gain,120661,120010,120812,120007,120579,120142,82,569
2018.01.03,132,437,82,down,651,99,536,211,up,846,gain,120889,120043,120661,120010,120142,120678,99,747
2018.01.04,99,536,211,Up,846,92,380,150,down,622,gain,120828,120206,120889,120043,120678,120298,150,472
2018.01.05,92,380,150,down,622,113,599,255,down,967,pert,120523,119556,120828,120206,120268,119669,712,255
2018.01.08,113,599,255,down,967,209,305,87,down,601,pert,119756,119155,120523,119556,119669,119364,514,87
2018.01.09,209,305,87,down,601,132,110,707,up,949,gain,120181,119232,119756,119155,119364,119474,132,817
2018.01.10,132,110,707,Up,949,181,840,274,up,1295,pert,120588,119293,120181,119232,119474,120314,1114,181
2018.01.11,181,840,274,Up,1295,6,1686,185,up,1877,pert,122185,120308,120588,119293,120314,122000,1871,6
2018.01.12,6,1686,185,Up,1877,57,694,339,up,1090,pert,122965,121875,122185,120308,121932,122626,1033,57
2018.01.15,57,694,339,Up,1090,644,31,208,down,883,gain,122834,121951,122965,121875,122626,122595,208,675
2018.01.16,644,31,208,down,883,74,752,636,down,1462,pert,123231,121769,122834,121951,122595,121843,826,636
2018.01.17,74,752,636,down,1462,191,526,279,up,996,gain,122648,121652,123231,121769,121843,122369,191,805
2018.01.18,191,526,279,Up,996,75,145,585,down,805,gain,122954,122149,122648,121652,122369,122224,585,220
2018.01.19,75,145,585,down,805,476,83,10,down,569,pert,122708,122139,122954,122149,122698,122615,559,10
2018.01.22,476,83,10,down,569,385,368,79,up,832,gain,123062,122230,122708,122139,122615,122983,385,447
2018.01.23,385,368,79,Up,832,67,1091,79,up,1237,pert,124149,122912,123062,122230,122979,124070,1170,67
2018.01.24,67,1091,79,Up,1237,288,144,1308,down,1740,gain,125378,123638,124149,122912,124070,123926,1308,432
2018.01.25,288,144,1308,down,1740,227,338,674,up,1239,gain,124938,123699,125378,123638,123926,124264,227,1012
2018.01.26,227,338,674,Up,1239,445,446,62,down,953,gain,124321,123368,124938,123699,124259,123813,62,891
2018.01.29,445,446,62,down,953,465,208,519,up,1192,gain,124540,123348,124321,123368,123813,124021,465,727
2018.01.30,465,208,519,Up,1192,147,115,616,up,878,pert,124748,123870,124540,123348,124017,124132,731,147
2018.01.31,147,115,616,Up,878,278,946,142,up,1366,pert,125220,123854,124748,123870,124132,125078,1088,278
2018.02.01,278,946,142,Up,1366,469,513,108,down,1090,gain,125181,124091,125220,123854,125073,124560,108,982
2018.02.02,469,513,108,down,1090,40,679,405,down,1124,pert,124749,123625,125181,124091,124344,123665,719,405
2018.02.05,40,679,405,down,1124,519,110,578,up,1207,gain,124346,123139,124749,123625,123658,123768,519,688
2018.02.06,519,110,578,Up,1207,170,1141,292,down,1603,gain,124060,122457,124346,123139,123768,122627,292,1311
2018.02.07,170,1141,292,down,1603,346,153,328,down,827,pert,122948,122121,124060,122457,122620,122467,499,328
2018.02.08,346,153,328,down,827,413,31,375,up,819,gain,122873,122054,122948,122121,122467,122498,413,406
2018.02.09,413,31,375,Up,819,92,464,67,up,623,pert,122973,122350,122873,122054,122442,122906,531,92
2018.02.12,92,464,67,Up,623,61,595,209,up,865,pert,123710,122845,122973,122350,122906,123501,804,61
2018.02.13,61,595,209,Up,865,739,997,157,up,1893,pert,124651,122758,123710,122845,123497,124494,1154,739
2018.02.14,739,997,157,Up,1893,11,571,40,up,622,pert,125102,124480,124651,122758,124491,125062,611,11
2018.02.15,11,571,40,Up,622,171,957,492,down,1620,gain,125554,123934,125102,124480,125062,124105,492,1128
2018.02.16,171,957,492,down,1620,317,62,282,up,661,gain,124352,123691,125554,123934,124008,124070,317,344
2018.02.19,317,62,282,Up,661,171,701,55,down,927,gain,124123,123196,124352,123691,124068,123367,55,872
2018.02.20,171,701,55,down,927,12,545,231,down,788,pert,123598,122810,124123,123196,123367,122822,557,231
2018.02.21,12,545,231,down,788,224,473,229,up,926,gain,123521,122595,123598,122810,122819,123292,224,702
2018.02.22,224,473,229,Up,926,137,357,77,down,571,gain,123369,122798,123521,122595,123292,122935,77,494
2018.02.23,137,357,77,down,571,151,237,383,up,771,gain,123550,122779,123369,122798,122930,123167,151,620
2018.02.26,151,237,383,Up,771,110,842,297,down,1249,gain,123464,122215,123550,122779,123167,122325,297,952
2018.02.27,110,842,297,down,1249,51,396,91,down,538,pert,122416,121878,123464,122215,122325,121929,447,91
2018.02.28,51,396,91,down,538,378,727,82,up,1187,gain,122733,121546,122416,121878,121924,122651,378,809
2018.03.01,378,727,82,Up,1187,137,533,175,up,845,pert,123359,122514,122733,121546,122651,123184,708,137
2018.03.02,137,533,175,Up,845,636,29,292,up,957,pert,123645,122688,123359,122514,123324,123353,321,636
2018.03.05,636,29,292,Up,957,73,680,168,up,921,pert,124201,123280,123645,122688,123353,124033,848,73
2018.03.06,73,680,168,Up,921,185,74,341,up,600,pert,124448,123848,124201,123280,124033,124107,415,185
2018.03.07,185,74,341,Up,600,124,1004,355,down,1483,gain,124462,122979,124448,123848,124107,123103,355,1128
2018.03.08,124,1004,355,down,1483,323,49,240,down,612,pert,123342,122730,124462,122979,123102,123053,372,240
2018.03.09,323,49,240,down,612,193,250,110,up,553,gain,123456,122903,123342,122730,123096,123346,193,360
2018.03.12,193,250,110,Up,553,199,567,163,up,929,pert,124074,123145,123456,122903,123344,123911,730,199
2018.03.13,199,567,163,Up,929,209,231,214,down,654,gain,124125,123471,124074,123145,123911,123680,214,440
2018.03.14,209,231,214,down,654,41,634,158,down,833,pert,123836,123003,124125,123471,123678,123044,675,158
2018.03.15,41,634,158,down,833,289,157,316,down,762,pert,123362,122600,123836,123003,123046,122889,446,316
2018.03.16,289,157,316,down,762,292,469,247,up,1008,gain,123588,122580,123362,122600,122872,123341,292,716
2018.03.19,292,469,247,Up,1008,39,906,206,down,1151,gain,123547,122396,123588,122580,123341,122435,206,945
2018.03.20,39,906,206,down,1151,18,950,113,up,1081,gain,123498,122417,123547,122396,122435,123385,18,1063
2018.03.21,18,950,113,Up,1081,206,329,500,down,1035,gain,123885,122850,123498,122417,123385,123056,500,535
2018.03.22,206,329,500,down,1035,0,458,219,up,677,gain,123733,123056,123885,122850,123056,123514,0,677
2018.03.23,0,458,219,Up,677,12,934,184,up,1130,pert,124615,123485,123733,123056,123497,124431,1118,12
2018.03.26,12,934,184,Up,1130,301,402,341,down,1044,gain,124763,123719,124615,123485,124422,124020,341,703
2018.03.27,301,402,341,down,1044,73,944,199,down,1216,pert,124216,123000,124763,123719,124017,123073,1017,199
2018.03.28,73,944,199,down,1216,162,78,279,down,519,pert,123358,122839,124216,123000,123079,123001,240,279
2018.03.29,162,78,279,down,519,133,219,86,up,438,gain,123304,122866,123358,122839,122999,123218,133,305
2018.03.30,133,219,86,Up,438,205,176,258,down,639,gain,123450,122811,123304,122866,123192,123016,258,381
2018.04.02,205,176,258,down,639,163,319,342,down,824,pert,123360,122536,123450,122811,123018,122699,482,342
2018.04.03,163,319,342,down,824,129,78,370,up,577,gain,123147,122570,123360,122536,122699,122777,129,448
2018.04.04,129,78,370,Up,577,218,373,129,down,720,gain,122903,122183,123147,122570,122774,122401,129,591
2018.04.05,218,373,129,down,720,245,415,99,up,759,gain,122908,122149,122903,122183,122394,122809,245,514
2018.04.06,245,415,99,Up,759,192,410,105,up,707,pert,123309,122602,122908,122149,122794,123204,515,192
2018.04.09,192,410,105,Up,707,157,373,219,up,749,pert,123776,123027,123309,122602,123184,123557,592,157
2018.04.10,157,373,219,Up,749,81,119,295,up,495,pert,123964,123469,123776,123027,123550,123669,414,81
2018.04.11,81,119,295,Up,495,269,396,141,down,806,gain,123798,122992,123964,123469,123657,123261,141,665
2018.04.12,269,396,141,down,806,185,35,169,up,389,gain,123459,123070,123798,122992,123255,123290,185,204
2018.04.13,185,35,169,Up,389,58,503,153,up,714,pert,123945,123231,123459,123070,123289,123792,656,58
2018.04.16,58,503,153,Up,714,332,91,354,down,777,gain,124137,123360,123945,123231,123783,123692,354,423
2018.04.17,332,91,354,down,777,274,45,237,up,556,gain,123971,123415,124137,123360,123689,123734,274,282
2018.04.18,274,45,237,Up,556,162,273,276,down,711,gain,124002,123291,123971,123415,123726,123453,276,435
2018.04.19,162,273,276,down,711,377,573,83,down,1033,pert,123529,122496,124002,123291,123446,122873,950,83
2018.04.20,377,573,83,down,1033,108,612,200,down,920,pert,122895,121975,123529,122496,122695,122083,720,200
2018.04.23,108,612,200,down,920,267,235,132,up,634,gain,122450,121816,122895,121975,122083,122318,267,367
2018.04.24,267,235,132,Up,634,5,706,76,down,787,gain,122387,121600,122450,121816,122311,121605,76,711
2018.04.25,5,706,76,down,787,68,568,500,down,1136,pert,122099,120963,122387,121600,121599,121031,636,500
2018.04.27,478,262,36,Up,776,133,474,139,down,746,gain,121387,120641,121329,120553,121248,120774,139,607
2018.04.30,133,474,139,down,746,107,851,68,down,1026,pert,120840,119814,121387,120641,120772,119921,958,68
2018.05.01,107,851,68,down,1026,124,418,395,down,937,pert,120316,119379,120840,119814,119921,119503,542,395
2018.05.02,124,418,395,down,937,26,375,210,up,611,gain,120088,119477,120316,119379,119503,119878,26,585
2018.05.03,26,375,210,Up,611,501,269,76,down,846,gain,119954,119108,120088,119477,119878,119609,76,770
2018.05.04,501,269,76,down,846,243,289,273,down,805,pert,119780,118975,119954,119108,119507,119218,532,273
2018.05.07,243,289,273,down,805,260,578,169,down,1007,pert,119387,118380,119780,118975,119218,118640,838,169
2018.05.08,260,578,169,down,1007,275,137,331,down,743,pert,118969,118226,119387,118380,118638,118501,412,331
2018.05.09,275,137,331,down,743,73,647,316,up,1036,gain,119465,118429,118969,118226,118502,119149,73,963
2018.05.10,73,647,316,Up,1036,234,272,262,up,768,pert,119679,118911,119465,118429,119145,119417,534,234
2018.05.11,234,272,262,Up,768,2,156,543,down,701,gain,119961,119260,119679,118911,119418,119262,543,158
2018.05.14,2,156,543,down,701,173,887,124,down,1184,pert,119385,118201,119961,119260,119261,118374,1060,124
2018.05.15,173,887,124,down,1184,438,305,169,down,912,pert,118543,117631,119385,118201,118374,118069,743,169
2018.05.16,438,305,169,down,912,168,134,309,down,611,pert,118374,117763,118543,117631,118065,117931,302,309
2018.05.17,168,134,309,down,611,207,233,283,down,723,pert,118221,117498,118374,117763,117938,117705,440,283
2018.05.18,207,233,283,down,723,530,215,46,up,791,gain,117957,117166,118221,117498,117696,117911,530,261
2018.05.21,530,215,46,Up,791,215,131,386,down,732,gain,118297,117565,117957,117166,117911,117780,386,346
2018.05.22,215,131,386,down,732,193,831,114,down,1138,pert,117896,116758,118297,117565,117782,116951,1024,114
2018.05.23,193,831,114,down,1138,41,244,311,up,596,gain,117503,116907,117896,116758,116948,117192,41,555
2018.05.24,41,244,311,Up,596,40,710,133,down,883,gain,117335,116452,117503,116907,117202,116492,133,750
2018.05.25,40,710,133,down,883,165,585,461,down,1211,pert,117284,116073,117335,116452,116823,116238,750,461
2018.05.28,165,585,461,down,1211,293,839,166,down,1298,pert,116396,115098,117284,116073,116230,115391,1132,166
2018.05.29,293,839,166,down,1298,163,1273,140,up,1576,gain,116762,115186,116396,115098,115349,116622,163,1413
2018.05.30,163,1273,140,Up,1576,213,284,338,up,835,pert,117244,116409,116762,115186,116622,116906,622,213
2018.05.31,213,284,338,Up,835,430,283,300,down,1013,gain,117179,116166,117244,116409,116879,116596,300,713
2018.06.01,430,283,300,down,1013,0,424,467,up,891,gain,117445,116554,117179,116166,116554,116978,0,891
2018.06.04,0,424,467,Up,891,440,201,154,up,795,pert,117321,116526,117445,116554,116966,117167,355,440
2018.06.05,440,201,154,Up,795,11,617,221,up,849,pert,117956,117107,117321,116526,117118,117735,838,11
2018.06.06,11,617,221,Up,849,5,251,419,up,675,pert,118398,117723,117956,117107,117728,117979,670,5
2018.06.07,5,251,419,Up,675,424,288,122,down,834,gain,118103,117269,118398,117723,117981,117693,122,712
2018.06.08,424,288,122,down,834,22,96,376,up,494,gain,118204,117710,118103,117269,117732,117828,22,472
2018.06.11,22,96,376,Up,494,125,367,269,down,761,gain,118090,117329,118204,117710,117821,117454,269,492
2018.06.12,125,367,269,down,761,212,451,96,up,759,gain,118008,117249,118090,117329,117461,117912,212,547
2018.06.13,212,451,96,Up,759,31,2249,611,down,2891,gain,118519,115628,118008,117249,117908,115659,611,2280
2018.06.14,31,2249,611,down,2891,250,390,200,up,840,gain,116270,115430,118519,115628,115680,116070,250,590
2018.06.15,250,390,200,Up,840,222,348,20,up,590,pert,116242,115652,116270,115430,115874,116222,368,222
2018.06.18,222,348,20,Up,590,572,347,219,down,1138,gain,116443,115305,116242,115652,116224,115877,219,919
2018.06.19,572,347,219,down,1138,345,168,127,down,640,pert,115999,115359,116443,115305,115872,115704,513,127
2018.06.20,345,168,127,down,640,617,330,310,up,1257,gain,116335,115078,115999,115359,115695,116025,617,640
2018.06.21,617,330,310,Up,1257,1,556,210,up,767,pert,116749,115982,116335,115078,115983,116539,766,1
2018.06.22,1,556,210,Up,767,351,392,103,up,846,pert,117130,116284,116749,115982,116635,117027,495,351
2018.06.25,351,392,103,Up,846,113,567,178,down,858,gain,117205,116347,117130,116284,117027,116460,178,680
2018.06.26,113,567,178,down,858,120,931,266,down,1317,pert,116721,115404,117205,116347,116455,115524,1051,266
2018.06.27,120,931,266,down,1317,245,163,327,up,735,gain,116006,115271,116721,115404,115516,115679,245,490
2018.06.28,245,163,327,Up,735,92,1159,72,up,1323,pert,116903,115580,116006,115271,115672,116831,1231,92
2018.06.29,92,1159,72,Up,1323,476,453,53,down,982,gain,116894,115912,116903,115580,116841,116388,53,929
2018.07.02,476,453,53,down,982,183,164,181,up,528,gain,116731,116203,116894,115912,116386,116550,183,345
2018.07.03,183,164,181,Up,528,250,4,258,down,512,gain,116817,116305,116731,116203,116559,116555,258,254
2018.07.04,250,4,258,down,512,55,341,308,up,704,gain,117203,116499,116817,116305,116554,116895,55,649
2018.07.05,55,341,308,Up,704,92,543,244,up,879,pert,117679,116800,117203,116499,116892,117435,787,92
2018.07.06,92,543,244,Up,879,56,114,412,up,582,pert,117908,117326,117679,116800,117382,117496,526,56
2018.07.09,56,114,412,Up,582,536,57,131,down,724,gain,117626,116902,117908,117326,117495,117438,131,593
2018.07.10,536,57,131,down,724,61,710,160,down,931,pert,117584,116653,117626,116902,117424,116714,771,160
2018.07.11,61,710,160,down,931,209,13,239,down,461,pert,116957,116496,117584,116653,116718,116705,222,239
2018.07.12,209,13,239,down,461,570,158,11,up,739,gain,116867,116128,116957,116496,116698,116856,570,169
2018.07.13,570,158,11,Up,739,140,213,146,up,499,pert,117254,116755,116867,116128,116895,117108,359,140
2018.07.16,140,213,146,Up,499,111,492,352,down,955,gain,117446,116491,117254,116755,117094,116602,352,603
2018.07.17,111,492,352,down,955,361,211,58,down,630,pert,116649,116019,117446,116491,116591,116380,572,58
2018.07.18,361,211,58,down,630,634,28,376,up,1038,gain,116785,115747,116649,116019,116381,116409,634,404
2018.07.19,634,28,376,Up,1038,157,790,179,up,1126,pert,117388,116262,116785,115747,116419,117209,969,157
2018.07.20,157,790,179,Up,1126,82,346,236,down,664,gain,117497,116833,117388,116262,117261,116915,236,428
2018.07.23,82,346,236,down,664,314,57,252,down,623,pert,117165,116542,117497,116833,116913,116856,371,252
2018.07.24,314,57,252,down,623,221,424,102,up,747,gain,117382,116635,117165,116542,116856,117280,221,526
2018.07.25,221,424,102,Up,747,26,867,143,down,1036,gain,117433,116397,117382,116635,117290,116423,143,893
2018.07.26,26,867,143,down,1036,204,162,75,up,441,gain,116640,116199,117433,116397,116403,116565,204,237
2018.07.27,204,162,75,Up,441,86,487,134,up,707,pert,117184,116477,116640,116199,116563,117050,621,86
2018.07.30,86,487,134,Up,707,51,121,428,down,600,gain,117455,116855,117184,116477,117027,116906,428,172
2018.07.31,51,121,428,down,600,26,301,98,down,425,pert,116993,116568,117455,116855,116895,116594,327,98
2018.08.01,26,301,98,down,425,27,750,81,down,858,pert,116671,115813,116993,116568,116590,115840,777,81
2018.08.02,27,750,81,down,858,74,166,264,down,504,pert,116102,115598,116671,115813,115838,115672,240,264
2018.08.03,74,166,264,down,504,236,149,27,down,412,pert,115708,115296,116102,115598,115681,115532,385,27
2018.08.06,236,149,27,down,412,32,447,99,up,578,gain,116078,115500,115708,115296,115532,115979,32,546
2018.08.07,32,447,99,Up,578,251,116,182,up,549,pert,116278,115729,116078,115500,115980,116096,298,251
2018.08.08,251,116,182,Up,549,12,831,93,down,936,gain,116189,115253,116278,115729,116096,115265,93,843
2018.08.09,12,831,93,down,936,233,1151,98,down,1482,pert,115360,113878,116189,115253,115262,114111,1384,98
2018.08.10,233,1151,98,down,1482,68,382,228,up,678,gain,114324,113646,115360,113878,113714,114096,68,610
2018.08.13,68,382,228,Up,678,139,659,195,down,993,gain,114290,113297,114324,113646,114095,113436,195,798
2018.08.14,139,659,195,down,993,423,15,102,up,540,gain,113546,113006,114290,113297,113429,113444,423,117
2018.08.15,423,15,102,Up,540,99,306,330,up,735,pert,114088,113353,113546,113006,113452,113758,636,99
2018.08.16,99,306,330,Up,735,98,623,64,up,785,pert,114445,113660,114088,113353,113758,114381,687,98
2018.08.17,98,623,64,Up,785,426,441,39,up,906,pert,114846,113940,114445,113660,114366,114807,480,426
2018.08.20,426,441,39,Up,906,9,898,308,up,1215,pert,116008,114793,114846,113940,114802,115700,1206,9
2018.08.21,9,898,308,Up,1215,168,262,268,up,698,pert,116226,115528,116008,114793,115696,115958,530,168
2018.08.22,168,262,268,Up,698,86,558,57,down,701,gain,115993,115292,116226,115528,115936,115378,57,644
2018.08.23,86,558,57,down,701,25,849,176,up,1050,gain,116394,115344,115993,115292,115369,116218,25,1025
2018.08.24,25,849,176,Up,1050,219,617,155,up,991,pert,116932,115941,116394,115344,116160,116777,772,219
2018.08.27,219,617,155,Up,991,144,173,394,up,711,pert,117333,116622,116932,115941,116766,116939,567,144
2018.08.28,144,173,394,Up,711,425,124,33,up,582,pert,117096,116514,117333,116622,116939,117063,157,425
2018.08.30,284,366,115,down,765,179,631,245,down,1055,pert,116897,115842,117178,116413,116652,116021,810,245
2018.08.31,179,631,245,down,1055,70,225,95,up,390,gain,116275,115885,116897,115842,115955,116180,70,320
2018.09.03,70,225,95,Up,390,507,365,38,down,910,gain,116207,115297,116275,115885,116169,115804,38,872
2018.09.04,507,365,38,down,910,379,488,109,up,976,gain,116398,115422,116207,115297,115801,116289,379,597
2018.09.05,379,488,109,Up,976,176,71,291,down,538,gain,116588,116050,116398,115422,116297,116226,291,247
2018.09.06,176,71,291,down,538,25,700,265,down,990,pert,116491,115501,116588,116050,116226,115526,725,265
2018.09.07,25,700,265,down,990,239,436,228,up,903,gain,116158,115255,116491,115501,115494,115930,239,664
2018.09.10,239,436,228,Up,903,273,122,393,up,788,pert,116438,115650,116158,115255,115923,116045,515,273
2018.09.11,273,122,393,Up,788,345,211,241,up,797,pert,116493,115696,116438,115650,116041,116252,452,345
2018.09.12,345,211,241,Up,797,166,644,110,up,920,pert,117007,116087,116493,115696,116253,116897,754,166
2018.09.13,166,644,110,Up,920,17,673,321,down,1011,gain,117213,116202,117007,116087,116892,116219,321,690
2018.09.14,17,673,321,down,1011,56,598,149,up,803,gain,116978,116175,117213,116202,116231,116829,56,747
2018.09.17,56,598,149,Up,803,133,179,412,down,724,gain,117241,116517,116978,116175,116829,116650,412,312
2018.09.18,133,179,412,down,724,153,71,426,up,650,gain,117146,116496,117241,116517,116649,116720,153,497
2018.09.19,153,71,426,Up,650,33,1047,77,up,1157,pert,117842,116685,117146,116496,116718,117765,1124,33
2018.09.20,33,1047,77,Up,1157,214,225,262,down,701,gain,118024,117323,117842,116685,117762,117537,262,439
2018.09.21,214,225,262,down,701,168,67,676,up,911,gain,118148,117237,118024,117323,117405,117472,168,743
2018.09.24,168,67,676,Up,911,176,178,263,up,617,pert,117921,117304,118148,117237,117480,117658,441,176
2018.09.25,176,178,263,Up,617,123,274,321,down,718,gain,117974,117256,117921,117304,117653,117379,321,397
2018.09.26,123,274,321,down,718,22,955,206,down,1183,pert,117568,116385,117974,117256,117362,116407,977,206
2018.09.27,22,955,206,down,1183,327,387,102,down,816,pert,116509,115693,117568,116385,116407,116020,714,102
2018.09.28,327,387,102,down,816,146,378,87,down,611,pert,116243,115632,116509,115693,116156,115778,524,87
2018.10.01,146,378,87,down,611,412,330,10,down,752,pert,115800,115048,116243,115632,115790,115460,742,10
2018.10.02,412,330,10,down,752,127,708,459,down,1294,pert,115933,114639,115800,115048,115474,114766,835,459
2018.10.03,127,708,459,down,1294,132,372,290,up,794,gain,115424,114630,115933,114639,114762,115134,132,662
2018.10.04,132,372,290,Up,794,302,95,260,up,657,pert,115494,114837,115424,114630,115139,115234,355,302
2018.10.05,302,95,260,Up,657,311,298,87,down,696,gain,115292,114596,115494,114837,115205,114907,87,609
2018.10.08,311,298,87,down,696,581,4,126,down,711,pert,115029,114318,115292,114596,114903,114899,585,126
2018.10.09,581,4,126,down,711,105,283,268,up,656,gain,115450,114794,115029,114318,114899,115182,105,551
2018.10.10,105,283,268,Up,656,11,744,59,up,814,pert,115989,115175,115450,114794,115186,115930,803,11
2018.10.11,11,744,59,Up,814,245,277,240,down,762,gain,116101,115339,115989,115175,115861,115584,240,522
2018.10.12,245,277,240,down,762,0,420,275,up,695,gain,116059,115364,116101,115339,115364,115784,0,695
2018.10.15,0,420,275,Up,695,76,53,423,down,552,gain,116209,115657,116059,115364,115786,115733,423,129
2018.10.16,76,53,423,down,552,45,734,68,down,847,pert,115801,114954,116209,115657,115733,114999,779,68
2018.10.17,45,734,68,down,847,36,477,268,down,781,pert,115268,114487,115801,114954,115000,114523,513,268
2018.10.18,36,477,268,down,781,196,620,200,up,1016,gain,115342,114326,115268,114487,114522,115142,196,820
2018.10.19,196,620,200,Up,1016,84,523,338,down,945,gain,115498,114553,115342,114326,115160,114637,338,607
2018.10.22,84,523,338,down,945,246,62,234,up,542,gain,114931,114389,115498,114553,114635,114697,246,296
2018.10.23,246,62,234,Up,542,128,793,57,down,978,gain,114761,113783,114931,114389,114704,113911,57,921
2018.10.24,128,793,57,down,978,188,173,403,down,764,pert,114322,113558,114761,113783,113919,113746,361,403
2018.10.25,188,173,403,down,764,378,290,185,up,853,gain,114206,113353,114322,113558,113731,114021,378,475
2018.10.26,378,290,185,Up,853,118,258,182,down,558,gain,114160,113602,114206,113353,113978,113720,182,376
2018.10.29,118,258,182,down,558,30,288,155,down,473,pert,113874,113401,114160,113602,113719,113431,318,155
2018.10.30,30,288,155,down,473,118,296,167,down,581,pert,113598,113017,113874,113401,113431,113135,414,167
2018.10.31,118,296,167,down,581,11,880,224,up,1115,gain,114238,113123,113598,113017,113134,114014,11,1104
2018.11.01,11,880,224,Up,1115,141,155,541,down,837,gain,114555,113718,114238,113123,114014,113859,541,296
2018.11.02,141,155,541,down,837,327,214,169,up,710,gain,114236,113526,114555,113718,113853,114067,327,383
2018.11.05,327,214,169,Up,710,154,196,115,up,465,pert,114375,113910,114236,113526,114064,114260,311,154
2018.11.06,154,196,115,Up,465,313,6,733,down,1052,gain,114994,113942,114375,113910,114261,114255,733,319
2018.11.07,313,6,733,down,1052,117,624,212,down,953,pert,114465,113512,114994,113942,114253,113629,741,212
2018.11.08,117,624,212,down,953,186,285,57,down,528,pert,113685,113157,114465,113512,113628,113343,471,57
2018.11.09,186,285,57,down,528,21,1010,119,down,1150,pert,113303,112153,113685,113157,113184,112174,1031,119
2018.11.12,21,1010,119,down,1150,14,722,35,up,771,gain,112933,112162,113303,112153,112176,112898,14,757
2018.11.13,14,722,35,Up,771,276,176,392,up,844,pert,113472,112628,112933,112162,112904,113080,568,276
2018.11.14,276,176,392,Up,844,386,166,365,up,917,pert,113620,112703,113472,112628,113089,113255,531,386
2018.11.15,386,166,365,Up,917,38,891,59,up,988,pert,114199,113211,113620,112703,113249,114140,950,38
2018.11.16,38,891,59,Up,988,201,388,116,up,705,pert,114640,113935,114199,113211,114136,114524,504,201
2018.11.19,201,388,116,Up,705,112,834,190,down,1136,gain,114719,113583,114640,113935,114529,113695,190,946
2018.11.20,112,834,190,down,1136,50,148,400,up,598,gain,114243,113645,114719,113583,113695,113843,50,548
2018.11.21,50,148,400,Up,598,49,157,332,up,538,pert,114337,113799,114243,113645,113848,114005,489,49
2018.11.22,49,157,332,Up,538,26,707,205,down,938,gain,114208,113270,114337,113799,114003,113296,205,733
2018.11.23,26,707,205,down,938,27,118,443,down,588,pert,113834,113246,114208,113270,113391,113273,145,443
2018.11.26,27,118,443,down,588,104,400,160,down,664,pert,113434,112770,113834,113246,113274,112874,504,160
2018.11.27,104,400,160,down,664,182,810,216,up,1208,gain,113875,112667,113434,112770,112849,113659,182,1026
2018.11.28,182,810,216,Up,1208,175,267,88,up,530,pert,114013,113483,113875,112667,113658,113925,355,175
2018.11.29,175,267,88,Up,530,105,769,77,down,951,gain,114001,113050,114013,113483,113924,113155,77,874
2018.11.30,105,769,77,down,951,310,35,259,up,604,gain,113793,113189,114001,113050,113499,113534,310,294
2018.12.03,310,35,259,Up,604,242,112,650,down,1004,gain,114185,113181,113793,113189,113535,113423,650,354
2018.12.04,242,112,650,down,1004,309,32,164,up,505,gain,113609,113104,114185,113181,113413,113445,309,196
2018.12.05,309,32,164,Up,505,242,299,377,up,918,pert,114123,113205,113609,113104,113447,113746,676,242
2018.12.06,242,299,377,Up,918,167,195,271,up,633,pert,114233,113600,114123,113205,113767,113962,466,167
2018.12.07,167,195,271,Up,633,52,341,530,down,923,gain,114423,113500,114233,113600,113893,113552,530,393
2018.12.10,52,341,530,down,923,104,385,453,down,942,pert,114001,113059,114423,113500,113548,113163,489,453
2018.12.11,104,385,453,down,942,14,520,188,up,722,gain,113868,113146,114001,113059,113160,113680,14,708
2018.12.12,14,520,188,Up,722,276,103,244,down,623,gain,113930,113307,113868,113146,113686,113583,244,379
2018.12.13,276,103,244,down,623,359,521,72,down,952,pert,113646,112694,113930,113307,113574,113053,880,72
2018.12.14,359,521,72,down,952,38,476,103,up,617,gain,113574,112957,113646,112694,112995,113471,38,579
2018.12.17,38,476,103,Up,617,106,131,418,up,655,pert,114018,113363,113574,112957,113469,113600,549,106
2018.12.18,106,131,418,Up,655,0,161,628,up,789,pert,114388,113599,114018,113363,113599,113760,789,0
2018.12.19,0,161,628,Up,789,72,690,403,up,1165,pert,114855,113690,114388,113599,113762,114452,1093,72
2018.12.20,72,690,403,Up,1165,109,788,283,down,1180,gain,114736,113556,114855,113690,114453,113665,283,897
2018.12.21,109,788,283,down,1180,76,489,217,up,782,gain,114381,113599,114736,113556,113675,114164,76,706
2018.12.24,76,489,217,Up,782,98,624,3,down,725,gain,114147,113422,114381,113599,114144,113520,3,722
2018.12.26,98,624,3,down,725,24,756,246,up,1026,gain,114538,113512,114147,113422,113536,114292,24,1002
2018.12.28,49,89,325,Up,463,127,221,97,up,445,pert,114655,114210,114723,114260,114337,114558,318,127
2018.12.31,127,221,97,Up,445,190,1017,513,down,1720,gain,114967,113247,114655,114210,114454,113437,513,1207
2019.01.02,190,1017,513,down,1720,348,493,178,up,1019,gain,114107,113088,114967,113247,113436,113929,348,671
2019.01.03,348,493,178,Up,1019,470,32,232,up,734,pert,114187,113453,114107,113088,113923,113955,264,470
2019.01.04,470,32,232,Up,734,5,782,82,up,869,pert,114821,113952,114187,113453,113957,114739,864,5
2019.01.07,5,782,82,Up,869,190,331,104,down,625,gain,114841,114216,114821,113952,114737,114406,104,521
2019.01.08,190,331,104,down,625,39,1006,163,up,1208,gain,115578,114370,114841,114216,114409,115415,39,1169
2019.01.09,39,1006,163,Up,1208,150,422,282,down,854,gain,115698,114844,115578,114370,115416,114994,282,572
2019.01.10,150,422,282,down,854,50,372,402,down,824,pert,115400,114576,115698,114844,114998,114626,422,402
2019.01.11,50,372,402,down,824,68,109,138,up,315,gain,114816,114501,115400,114576,114569,114678,68,247
2019.01.14,68,109,138,Up,315,311,554,215,down,1080,gain,114893,113813,114816,114501,114678,114124,215,865
2019.01.15,311,554,215,down,1080,139,202,130,down,471,pert,114244,113773,114893,113813,114114,113912,341,130
2019.01.16,139,202,130,down,471,182,30,147,down,359,pert,114056,113697,114244,113773,113909,113879,212,147
2019.01.17,182,30,147,down,359,127,223,221,down,571,pert,114099,113528,114056,113697,113878,113655,350,221
2019.01.18,127,223,221,down,571,24,70,250,up,344,gain,113907,113563,114099,113528,113587,113657,24,320
2019.01.21,24,70,250,Up,344,238,46,95,down,379,gain,113735,113356,113907,113563,113640,113594,95,284
2019.01.22,238,46,95,down,379,88,214,133,up,435,gain,113940,113505,113735,113356,113593,113807,88,347
2019.01.23,88,214,133,Up,435,142,765,115,down,1022,gain,113911,112889,113940,113505,113796,113031,115,907
2019.01.24,142,765,115,down,1022,68,986,121,up,1175,gain,114172,112997,113911,112889,113065,114051,68,1107
2019.01.25,68,986,121,Up,1175,109,256,170,up,535,pert,114432,113897,114172,112997,114006,114262,426,109
2019.01.28,109,256,170,Up,535,145,67,178,up,390,pert,114498,114108,114432,113897,114253,114320,245,145
2019.01.29,145,67,178,Up,390,258,464,234,up,956,pert,115013,114057,114498,114108,114315,114779,698,258
2019.01.30,258,464,234,Up,956,108,328,350,down,786,gain,115139,114353,115013,114057,114789,114461,350,436
2019.01.31,108,328,350,down,786,129,61,351,up,541,gain,114880,114339,115139,114353,114468,114529,129,412
2019.02.01,129,61,351,Up,541,111,156,94,down,361,gain,114600,114239,114880,114339,114506,114350,94,267
2019.02.04,111,156,94,down,361,36,308,50,down,394,pert,114401,114007,114600,114239,114351,114043,344,50
2019.02.05,36,308,50,down,394,3,431,53,down,487,pert,114091,113604,114401,114007,114038,113607,434,53
2019.02.06,3,431,53,down,487,143,227,68,down,438,pert,113680,113242,114091,113604,113612,113385,370,68
2019.02.07,143,227,68,down,438,11,157,131,down,299,pert,113505,113206,113680,113242,113374,113217,168,131
2019.02.08,11,157,131,down,299,73,448,100,down,621,pert,113296,112675,113505,113206,113196,112748,521,100
2019.02.11,73,448,100,down,621,170,503,146,up,819,gain,113392,112573,113296,112675,112743,113246,170,649
2019.02.12,170,503,146,Up,819,0,666,149,down,815,gain,113410,112595,113392,112573,113261,112595,149,666
2019.02.13,0,666,149,down,815,121,330,156,up,607,gain,113095,112488,113410,112595,112609,112939,121,486
2019.02.14,121,330,156,Up,607,569,45,108,down,722,gain,113058,112336,113095,112488,112950,112905,108,614
2019.02.15,569,45,108,down,722,31,164,254,up,449,gain,113335,112886,113058,112336,112917,113081,31,418
2019.02.18,31,164,254,Up,449,337,307,177,up,821,pert,113571,112750,113335,112886,113087,113394,484,337
2019.02.19,337,307,177,Up,821,108,48,308,down,464,gain,113707,113243,113571,112750,113399,113351,308,156
2019.02.20,108,48,308,down,464,133,38,292,down,463,pert,113660,113197,113707,113243,113368,113330,171,292
2019.02.21,133,38,292,down,463,146,16,233,down,395,pert,113552,113157,113660,113197,113319,113303,162,233
2019.02.22,146,16,233,down,395,62,228,111,up,401,gain,113671,113270,113552,113157,113332,113560,62,339
2019.02.25,62,228,111,Up,401,117,316,144,up,577,pert,114024,113447,113671,113270,113564,113880,460,117
2019.02.26,117,316,144,Up,577,66,202,145,down,413,gain,114032,113619,114024,113447,113887,113685,145,268
2019.02.27,66,202,145,down,413,102,4,496,up,602,gain,114192,113590,114032,113619,113692,113696,102,500
2019.02.28,102,4,496,Up,602,97,71,384,down,552,gain,114081,113529,114192,113590,113697,113626,384,168
2019.03.01,97,71,384,down,552,299,348,76,down,723,pert,113810,113087,114081,113529,113734,113386,647,76
2019.03.04,299,348,76,down,723,177,324,13,down,514,pert,113406,112892,113810,113087,113393,113069,501,13
2019.03.05,177,324,13,down,514,201,14,176,down,391,pert,113243,112852,113406,112892,113067,113053,215,176
2019.03.06,201,14,176,down,391,167,1135,140,down,1442,pert,113198,111756,113243,112852,113058,111923,1302,140
2019.03.07,167,1135,140,down,1442,81,395,133,up,609,gain,112457,111848,113198,111756,111929,112324,81,528
2019.03.08,81,395,133,Up,609,131,140,95,up,366,pert,112580,112214,112457,111848,112345,112485,235,131
2019.03.11,131,140,95,Up,366,15,393,169,up,577,pert,113046,112469,112580,112214,112484,112877,562,15
2019.03.12,15,393,169,Up,577,107,424,82,up,613,pert,113383,112770,113046,112469,112877,113301,506,107
2019.03.13,107,424,82,Up,613,105,257,72,down,434,gain,113372,112938,113383,112770,113300,113043,72,362
2019.03.14,105,257,72,down,434,44,197,202,up,443,gain,113439,112996,113372,112938,113040,113237,44,399
2019.03.15,44,197,202,Up,443,44,119,237,up,400,pert,113586,113186,113439,112996,113230,113349,356,44
2019.03.18,44,119,237,Up,400,16,144,120,up,280,pert,113612,113332,113586,113186,113348,113492,264,16
2019.03.19,16,144,120,Up,280,141,747,239,up,1127,pert,114477,113350,113612,113332,113491,114238,986,141
2019.03.20,141,747,239,Up,1127,307,511,131,down,949,gain,114369,113420,114477,113350,114238,113727,131,818
2019.03.21,307,511,131,down,949,277,721,176,down,1174,pert,113903,112729,114369,113420,113727,113006,998,176
2019.03.22,277,721,176,down,1174,49,191,185,up,425,gain,113310,112885,113903,112729,112934,113125,49,376
2019.03.25,49,191,185,Up,425,72,426,131,down,629,gain,113256,112627,113310,112885,113125,112699,131,498
2019.03.26,72,426,131,down,629,90,190,154,down,434,pert,112852,112418,113256,112627,112698,112508,280,154
2019.03.27,90,190,154,down,434,127,249,101,down,477,pert,112609,112132,112852,112418,112508,112259,376,101
2019.03.28,127,249,101,down,477,72,95,202,down,369,pert,112463,112094,112609,112132,112261,112166,167,202
2019.03.29,72,95,202,down,369,81,141,238,down,460,pert,112496,112036,112463,112094,112258,112117,222,238
2019.04.01,81,141,238,down,460,200,88,36,down,324,pert,112157,111833,112496,112036,112121,112033,288,36
2019.04.02,200,88,36,down,324,42,275,231,up,548,gain,112543,111995,112157,111833,112037,112312,42,506
2019.04.03,42,275,231,Up,548,135,133,148,down,416,gain,112472,112056,112543,111995,112324,112191,148,268
2019.04.04,135,133,148,down,416,56,48,276,down,380,pert,112476,112096,112472,112056,112200,112152,104,276
2019.04.05,56,48,276,down,380,38,470,132,up,640,gain,112741,112101,112476,112096,112139,112609,38,602
2019.04.08,38,470,132,Up,640,41,22,229,up,292,pert,112838,112546,112741,112101,112587,112609,251,41
2019.04.09,41,22,229,Up,292,325,99,148,up,572,pert,112872,112300,112838,112546,112625,112724,247,325
2019.04.10,325,99,148,Up,572,12,232,131,down,375,gain,112870,112495,112872,112300,112739,112507,131,244
2019.04.11,12,232,131,down,375,34,443,254,up,731,gain,113235,112504,112870,112495,112538,112981,34,697
2019.04.12,34,443,254,Up,731,51,9,173,down,233,gain,113205,112972,113235,112504,113032,113023,173,60
2019.04.15,51,9,173,down,233,6,237,99,down,342,pert,113135,112793,113205,112972,113036,112799,243,99
2019.04.16,6,237,99,down,342,17,146,288,up,451,gain,113234,112783,113135,112793,112800,112946,17,434
2019.04.17,17,146,288,Up,451,47,681,51,down,779,gain,113037,112258,113234,112783,112986,112305,51,728
2019.04.18,47,681,51,down,779,38,82,85,up,205,gain,112473,112268,113037,112258,112306,112388,38,167
2019.04.19,38,82,85,Up,205,42,164,56,up,262,pert,112616,112354,112473,112268,112396,112560,220,42
2019.04.22,42,164,56,Up,262,344,305,42,down,691,gain,112609,111918,112616,112354,112567,112262,42,649
2019.04.23,344,305,42,down,691,123,746,0,down,869,pert,112270,111401,112609,111918,112270,111524,869,0
2019.04.24,123,746,0,down,869,140,203,104,down,447,pert,111620,111173,112270,111401,111516,111313,343,104
2019.04.25,140,203,104,down,447,217,98,315,up,630,gain,111735,111105,111620,111173,111322,111420,217,413
2019.04.29,0,462,12,Up,474,88,299,146,up,533,pert,112286,111753,111864,111390,111841,112140,445,88
2019.04.30,88,299,146,Up,533,74,207,496,down,777,gain,112644,111867,112286,111753,112148,111941,496,281
2019.05.01,74,207,496,down,777,6,233,245,down,484,pert,112187,111703,112644,111867,111942,111709,239,245
2019.05.02,6,233,245,down,484,364,311,24,up,699,gain,112045,111346,112187,111703,111710,112021,364,335
2019.05.03,364,311,24,Up,699,37,271,112,up,420,pert,112090,111670,112045,111346,111707,111978,383,37
2019.05.06,37,271,112,Up,420,244,79,191,down,514,gain,112176,111662,112090,111670,111985,111906,191,323
2019.05.07,244,79,191,down,514,81,10,220,down,311,pert,112134,111823,112176,111662,111914,111904,91,220
2019.05.08,81,10,220,down,311,186,212,377,up,775,gain,112505,111730,112134,111823,111916,112128,186,589
2019.05.09,186,212,377,Up,775,0,218,199,up,417,pert,112532,112115,112505,111730,112115,112333,417,0
2019.05.10,0,218,199,Up,417,0,88,335,down,423,gain,112631,112208,112532,112115,112296,112208,335,88
2019.05.13,0,88,335,down,423,20,212,196,down,428,pert,112436,112008,112631,112208,112240,112028,232,196
2019.05.14,20,212,196,down,428,224,29,213,down,466,pert,112242,111776,112436,112008,112029,112000,253,213
2019.05.15,224,29,213,down,466,76,279,223,down,578,pert,112236,111658,112242,111776,112013,111734,355,223
2019.05.16,76,279,223,down,578,17,158,116,down,291,pert,111839,111548,112236,111658,111723,111565,175,116
2019.05.17,17,158,116,down,291,97,50,94,up,241,gain,111744,111503,111839,111548,111600,111650,97,144
2019.05.20,97,50,94,Up,241,182,51,227,down,460,gain,111876,111416,111744,111503,111649,111598,227,233
2019.05.21,182,51,227,down,460,11,118,187,down,316,pert,111799,111483,111876,111416,111612,111494,129,187
2019.05.22,11,118,187,down,316,433,308,64,up,805,gain,111871,111066,111799,111483,111499,111807,433,372
2019.05.23,433,308,64,Up,805,105,227,74,up,406,pert,112118,111712,111871,111066,111817,112044,301,105
2019.05.24,105,227,74,Up,406,43,186,56,down,285,gain,112150,111865,112118,111712,112094,111908,56,229
2019.05.27,43,186,56,down,285,5,316,102,down,423,pert,112009,111586,112150,111865,111907,111591,321,102
2019.05.28,5,316,102,down,423,62,292,127,down,481,pert,111721,111240,112009,111586,111594,111302,354,127
2019.05.29,62,292,127,down,481,126,23,124,down,273,pert,111430,111157,111721,111240,111306,111283,149,124
2019.05.30,126,23,124,down,273,39,389,119,up,547,gain,111795,111248,111430,111157,111287,111676,39,508
2019.05.31,39,389,119,Up,547,48,762,210,up,1020,pert,112616,111596,111795,111248,111644,112406,972,48
2019.06.03,48,762,210,Up,1020,144,100,262,up,506,pert,112769,112263,112616,111596,112407,112507,362,144
2019.06.04,144,100,262,Up,506,6,314,547,down,867,gain,113061,112194,112769,112263,112514,112200,547,320
2019.06.05,6,314,547,down,867,201,546,337,up,1084,gain,113084,112000,113061,112194,112201,112747,201,883
2019.06.06,201,546,337,Up,1084,240,573,152,up,965,pert,113474,112509,113084,112000,112749,113322,725,240
2019.06.07,240,573,152,Up,965,213,114,77,down,404,gain,113301,112897,113474,112509,113224,113110,77,327
2019.06.10,213,114,77,down,404,98,145,118,up,361,gain,113371,113010,113301,112897,113108,113253,98,263
2019.06.11,98,145,118,Up,361,46,387,177,down,610,gain,113430,112820,113371,113010,113253,112866,177,433
2019.06.12,46,387,177,down,610,82,104,168,down,354,pert,113033,112679,113430,112820,112865,112761,186,168
2019.06.13,82,104,168,down,354,83,658,127,down,868,pert,112888,112020,113033,112679,112761,112103,741,127
2019.06.14,83,658,127,down,868,55,90,289,up,434,gain,112467,112033,112888,112020,112088,112178,55,379
2019.06.17,55,90,289,Up,434,127,235,254,down,616,gain,112425,111809,112467,112033,112171,111936,254,362
2019.06.18,127,235,254,down,616,58,333,279,up,670,gain,112538,111868,112425,111809,111926,112259,58,612
2019.06.19,58,333,279,Up,670,3,661,257,up,921,pert,113173,112252,112538,111868,112255,112916,918,3
2019.06.20,3,661,257,Up,921,86,786,74,up,946,pert,113773,112827,113173,112252,112913,113699,860,86
2019.06.21,86,786,74,Up,946,42,282,58,up,382,pert,114036,113654,113773,112827,113696,113978,340,42
2019.06.24,42,282,58,Up,382,218,324,137,down,679,gain,114116,113437,114036,113654,113979,113655,137,542
2019.06.25,218,324,137,down,679,195,18,226,up,439,gain,113909,113470,114116,113437,113665,113683,195,244
2019.06.26,195,18,226,Up,439,210,5,122,up,337,pert,113811,113474,113909,113470,113684,113689,127,210
2019.06.27,210,5,122,Up,337,187,5,238,up,430,pert,113931,113501,113811,113474,113688,113693,243,187
2019.06.28,187,5,238,Up,430,45,819,37,down,901,gain,113707,112806,113931,113501,113670,112851,37,864
2019.07.01,45,819,37,down,901,102,7,355,up,464,gain,113212,112748,113707,112806,112850,112857,102,362
2019.07.02,102,7,355,Up,464,92,73,264,down,429,gain,113111,112682,113212,112748,112847,112774,264,165
2019.07.03,92,73,264,down,429,50,70,100,up,220,gain,112947,112727,113111,112682,112777,112847,50,170
2019.07.04,50,70,100,Up,220,178,589,37,down,804,gain,112874,112070,112947,112727,112837,112248,37,767
2019.07.05,178,589,37,down,804,73,98,103,down,274,pert,112343,112069,112874,112070,112240,112142,171,103
2019.07.08,73,98,103,down,274,146,63,46,down,255,pert,112187,111932,112343,112069,112141,112078,209,46
2019.07.09,146,63,46,down,255,58,427,139,up,624,gain,112642,112018,112187,111932,112076,112503,58,566
2019.07.10,58,427,139,Up,624,52,29,325,up,406,pert,112857,112451,112642,112018,112503,112532,354,52
2019.07.11,52,29,325,Up,406,149,167,49,up,365,pert,112748,112383,112857,112451,112532,112699,216,149
2019.07.12,149,167,49,Up,365,46,77,184,down,307,gain,112838,112531,112748,112383,112654,112577,184,123
2019.07.15,46,77,184,down,307,85,471,60,down,616,pert,112634,112018,112838,112531,112574,112103,556,60
2019.07.16,85,471,60,down,616,105,140,94,up,339,gain,112336,111997,112634,112018,112102,112242,105,234
2019.07.17,105,140,94,Up,339,186,528,39,up,753,pert,112804,112051,112336,111997,112237,112765,567,186
2019.07.18,186,528,39,Up,753,161,572,54,down,787,gain,112820,112033,112804,112051,112766,112194,54,733
2019.07.19,161,572,54,down,787,32,46,112,down,190,pert,112252,112062,112820,112033,112140,112094,78,112
2019.07.22,32,46,112,down,190,59,576,3,down,638,pert,112096,111458,112252,112062,112093,111517,635,3
2019.07.23,59,576,3,down,638,130,117,41,down,288,pert,111557,111269,112096,111458,111516,111399,247,41
2019.07.24,130,117,41,down,288,387,67,410,up,864,gain,111877,111013,111557,111269,111400,111467,387,477
2019.07.25,387,67,410,Up,864,152,194,45,down,391,gain,111509,111118,111877,111013,111464,111270,45,346
2019.07.26,152,194,45,down,391,124,190,66,up,380,gain,111509,111129,111509,111118,111253,111443,124,256
2019.07.29,124,190,66,Up,380,122,102,64,up,288,pert,111609,111321,111509,111129,111443,111545,166,122
2019.07.30,122,102,64,Up,288,148,799,72,down,1019,gain,111620,110601,111609,111321,111548,110749,72,947
2019.07.31,148,799,72,down,1019,480,98,110,up,688,gain,110957,110269,111620,110601,110749,110847,480,208
2019.08.01,480,98,110,Up,688,150,201,113,up,464,pert,111163,110699,110957,110269,110849,111050,314,150
2019.08.02,150,201,113,Up,464,5,1001,98,up,1104,pert,112131,111027,111163,110699,111032,112033,1099,5
2019.08.05,5,1001,98,Up,1104,307,54,461,down,822,gain,112495,111673,112131,111027,112034,111980,461,361
2019.08.06,307,54,461,down,822,190,2,437,up,629,gain,112419,111790,112495,111673,111980,111982,190,439
2019.08.07,190,2,437,Up,629,33,179,347,down,559,gain,112327,111768,112419,111790,111980,111801,347,212
2019.08.08,33,179,347,down,559,9,196,231,up,436,gain,112229,111793,112327,111768,111802,111998,9,427
2019.08.09,9,196,231,Up,436,358,154,175,up,687,pert,112306,111619,112229,111793,111977,112131,329,358
2019.08.12,358,154,175,Up,687,9,420,157,down,586,gain,112286,111700,112306,111619,112129,111709,157,429
2019.08.13,9,420,157,down,586,72,333,197,down,602,pert,111907,111305,112286,111700,111710,111377,405,197
2019.08.14,72,333,197,down,602,151,315,204,down,670,pert,111584,110914,111907,111305,111380,111065,466,204
2019.08.15,151,315,204,down,670,230,172,56,down,458,pert,111121,110663,111584,110914,111065,110893,402,56
2019.08.16,230,172,56,down,458,18,146,213,down,377,pert,111137,110760,111121,110663,110924,110778,164,213
2019.08.19,18,146,213,down,377,119,225,69,up,413,gain,111067,110654,111137,110760,110773,110998,119,294
2019.08.20,119,225,69,Up,413,45,144,81,down,270,gain,111070,110800,111067,110654,110989,110845,81,189
2019.08.21,45,144,81,down,270,164,45,287,down,496,pert,111131,110635,111070,110800,110844,110799,209,287
2019.08.22,164,45,287,down,496,283,588,145,up,1016,gain,111531,110515,111131,110635,110798,111386,283,733
2019.08.23,283,588,145,Up,1016,76,478,143,down,697,gain,111639,110942,111531,110515,111496,111018,143,554
2019.08.26,76,478,143,down,697,45,117,140,down,302,pert,111158,110856,111639,110942,111018,110901,162,140
2019.08.29,143,207,162,down,512,263,670,39,down,972,pert,110602,109630,110932,110420,110563,109893,933,39
2019.08.30,263,670,39,down,972,117,203,66,down,386,pert,109965,109579,110602,109630,109899,109696,320,66
2019.09.02,117,203,66,down,386,401,75,54,up,530,gain,109787,109257,109965,109579,109658,109733,401,129
2019.09.03,401,75,54,Up,530,53,611,35,up,699,pert,110383,109684,109787,109257,109737,110348,646,53
2019.09.04,53,611,35,Up,699,173,8,498,down,679,gain,110846,110167,110383,109684,110348,110340,498,181
2019.09.05,173,8,498,down,679,43,95,231,down,369,pert,110571,110202,110846,110167,110340,110245,138,231
2019.09.06,43,95,231,down,369,102,221,203,up,526,gain,110680,110154,110571,110202,110256,110477,102,424
2019.09.09,102,221,203,Up,526,128,42,119,down,289,gain,110593,110304,110680,110154,110474,110432,119,170
2019.09.10,128,42,119,down,289,251,328,125,down,704,pert,110555,109851,110593,110304,110430,110102,579,125
2019.09.11,251,328,125,down,704,835,541,227,up,1603,gain,110870,109267,110555,109851,110102,110643,835,768
2019.09.12,835,541,227,Up,1603,90,54,397,up,541,pert,111094,110553,110870,109267,110643,110697,451,90
2019.09.13,90,54,397,Up,541,71,717,143,down,931,gain,110863,109932,111094,110553,110720,110003,143,788
2019.09.16,71,717,143,down,931,96,727,20,up,843,gain,110745,109902,110863,109932,109998,110725,96,747
2019.09.17,96,727,20,Up,843,163,424,33,down,620,gain,110756,110136,110745,109902,110723,110299,33,587
2019.09.18,163,424,33,down,620,71,110,326,up,507,gain,110734,110227,110756,110136,110298,110408,71,436
2019.09.19,71,110,326,Up,507,225,221,267,down,713,gain,110675,109962,110734,110227,110408,110187,267,446
2019.09.20,225,221,267,down,713,265,195,133,down,593,pert,110253,109660,110675,109962,110120,109925,460,133
2019.09.23,265,195,133,down,593,90,266,46,up,402,gain,110239,109837,110253,109660,109927,110193,90,312
2019.09.24,90,266,46,Up,402,46,773,36,down,855,gain,110228,109373,110239,109837,110192,109419,36,819
2019.09.25,46,773,36,down,855,111,217,258,down,586,pert,109673,109087,110228,109373,109415,109198,328,258
2019.09.26,111,217,258,down,586,163,210,175,up,548,gain,109586,109038,109673,109087,109201,109411,163,385
2019.09.27,163,210,175,Up,548,145,412,73,down,630,gain,109476,108846,109586,109038,109403,108991,73,557
2019.09.30,145,412,73,down,630,201,326,110,up,637,gain,109427,108790,109476,108846,108991,109317,201,436
2019.10.01,201,326,110,Up,637,269,279,45,up,593,pert,109635,109042,109427,108790,109311,109590,324,269
2019.10.02,269,279,45,Up,593,175,46,362,up,583,pert,109992,109409,109635,109042,109584,109630,408,175
2019.10.03,175,46,362,Up,583,61,142,211,up,414,pert,109983,109569,109992,109409,109630,109772,353,61
2019.10.04,61,142,211,Up,414,86,86,216,down,388,gain,110006,109618,109983,109569,109790,109704,216,172
2019.10.07,86,86,216,down,388,149,143,256,down,548,pert,109959,109411,110006,109618,109703,109560,292,256
2019.10.08,149,143,256,down,548,46,150,191,up,387,gain,109901,109514,109959,109411,109560,109710,46,341
2019.10.09,46,150,191,Up,387,7,346,288,up,641,pert,110338,109697,109901,109514,109704,110050,634,7
2019.10.10,7,346,288,Up,641,41,311,267,up,619,pert,110627,110008,110338,109697,110049,110360,578,41
2019.10.11,41,311,267,Up,619,125,63,113,down,301,gain,110427,110126,110627,110008,110314,110251,113,188
2019.10.14,125,63,113,down,301,340,68,140,up,548,gain,110460,109912,110427,110126,110252,110320,340,208
2019.10.15,340,68,140,Up,548,94,391,144,up,629,pert,110854,110225,110460,109912,110319,110710,535,94
2019.10.16,94,391,144,Up,629,60,524,164,up,748,pert,111398,110650,110854,110225,110710,111234,688,60
2019.10.17,60,524,164,Up,748,90,453,13,up,556,pert,111702,111146,111398,110650,111236,111689,466,90
2019.10.18,90,453,13,Up,556,100,117,189,down,406,gain,111793,111387,111702,111146,111604,111487,189,217
2019.10.21,100,117,189,down,406,67,244,81,down,392,pert,111568,111176,111793,111387,111487,111243,311,81
2019.10.22,67,244,81,down,392,181,55,105,up,341,gain,111402,111061,111568,111176,111242,111297,181,160
2019.10.23,181,55,105,Up,341,107,259,330,down,696,gain,111626,110930,111402,111061,111296,111037,330,366
2019.10.24,107,259,330,down,696,65,242,192,down,499,pert,111228,110729,111626,110930,111036,110794,307,192
2019.10.25,65,242,192,down,499,28,206,71,up,305,gain,111065,110760,111228,110729,110788,110994,28,277
2019.10.28,28,206,71,Up,305,259,124,66,up,449,pert,111184,110735,111065,110760,110994,111118,190,259
2019.10.29,259,124,66,Up,449,317,399,17,up,733,pert,111533,110800,111184,110735,111117,111516,416,317
2019.10.30,317,399,17,Up,733,200,2,240,down,442,gain,111756,111314,111533,110800,111516,111514,240,202
2019.10.31,200,2,240,down,442,233,134,70,up,437,gain,111718,111281,111756,111314,111514,111648,233,204
2019.11.01,233,134,70,Up,437,25,415,66,down,506,gain,111753,111247,111718,111281,111687,111272,66,440
2019.11.04,25,415,66,down,506,108,527,132,down,767,pert,111401,110634,111753,111247,111269,110742,635,132
2019.11.05,108,527,132,down,767,9,84,185,down,278,pert,110927,110649,111401,110634,110742,110658,93,185
2019.11.06,9,84,185,down,278,136,161,257,down,554,pert,110915,110361,110927,110649,110658,110497,297,257
2019.11.07,136,161,257,down,554,23,303,61,down,387,pert,110553,110166,110915,110361,110492,110189,326,61
2019.11.08,23,303,61,down,387,21,138,107,up,266,gain,110430,110164,110553,110166,110185,110323,21,245
2019.11.11,21,138,107,Up,266,63,235,62,down,360,gain,110385,110025,110430,110164,110323,110088,62,298
2019.11.12,63,235,62,down,360,100,36,113,down,249,pert,110202,109953,110385,110025,110089,110053,136,113
2019.11.13,100,36,113,down,249,162,160,61,up,383,gain,110273,109890,110202,109953,110052,110212,162,221
2019.11.14,162,160,61,Up,383,67,303,52,up,422,pert,110567,110145,110273,109890,110212,110515,355,67
2019.11.15,67,303,52,Up,422,33,208,181,up,422,pert,110899,110477,110567,110145,110510,110718,389,33
2019.11.18,33,208,181,Up,422,94,62,58,up,214,pert,110838,110624,110899,110477,110718,110780,120,94
2019.11.19,94,62,58,Up,214,193,54,36,down,283,gain,110813,110530,110838,110624,110777,110723,36,247
2019.11.20,193,54,36,down,283,60,142,246,down,448,pert,110969,110521,110813,110530,110723,110581,202,246
2019.11.21,60,142,246,down,448,38,398,295,down,731,pert,110875,110144,110969,110521,110580,110182,436,295
2019.11.22,38,398,295,down,731,91,25,169,down,285,pert,110320,110035,110875,110144,110151,110126,116,169
2019.11.25,91,25,169,down,285,57,65,61,up,183,gain,110255,110072,110320,110035,110129,110194,57,126
2019.11.26,57,65,61,Up,183,66,205,52,down,323,gain,110246,109923,110255,110072,110194,109989,52,271
2019.11.27,66,205,52,down,323,1,88,103,up,192,gain,110178,109986,110246,109923,109987,110075,1,191
2019.11.28,1,88,103,Up,192,261,81,130,up,472,pert,110282,109810,110178,109986,110071,110152,211,261
2019.11.29,261,81,130,Up,472,212,543,126,up,881,pert,110910,110029,110282,109810,110241,110784,669,212
2019.12.02,212,543,126,Up,881,124,27,125,up,276,pert,110934,110658,110910,110029,110782,110809,152,124
2019.12.03,124,27,125,Up,276,108,34,352,down,494,gain,111161,110667,110934,110658,110809,110775,352,142
2019.12.04,108,34,352,down,494,1,270,37,up,308,gain,111079,110771,111161,110667,110772,111042,1,307
2019.12.05,1,270,37,Up,308,199,447,55,down,701,gain,111097,110396,111079,110771,111042,110595,55,646
2019.12.06,199,447,55,down,701,41,61,144,up,246,gain,110779,110533,111097,110396,110574,110635,41,205
2019.12.09,41,61,144,Up,246,8,284,57,up,349,pert,110976,110627,110779,110533,110635,110919,341,8
2019.12.10,8,284,57,Up,349,213,380,153,up,746,pert,111447,110701,110976,110627,110914,111294,533,213
2019.12.11,213,380,153,Up,746,256,8,247,down,511,gain,111541,111030,111447,110701,111294,111286,247,264
2019.12.12,256,8,247,down,511,141,121,699,down,961,pert,111993,111032,111541,111030,111294,111173,262,699
2019.12.13,141,121,699,down,961,33,175,146,up,354,gain,111580,111226,111993,111032,111259,111434,33,321
2019.12.16,33,175,146,Up,354,144,52,258,up,454,pert,111745,111291,111580,111226,111435,111487,310,144
2019.12.17,144,52,258,Up,454,25,356,58,down,439,gain,111541,111102,111745,111291,111483,111127,58,381
2019.12.18,25,356,58,down,439,54,78,238,up,370,gain,111442,111072,111541,111102,111126,111204,54,316
2019.12.19,54,78,238,Up,370,89,450,45,down,584,gain,111246,110662,111442,111072,111201,110751,45,539
2019.12.20,89,450,45,down,584,52,145,63,up,260,gain,110958,110698,111246,110662,110750,110895,52,208
2019.12.26,80,74,114,Up,268,33,787,122,up,942,pert,111882,110940,111088,110820,110973,111760,909,33
2019.12.30,41,231,221,Up,493,9,186,221,up,416,pert,112392,111976,112206,111713,111985,112171,407,9
2019.12.31,9,186,221,Up,416,87,410,11,down,508,gain,112143,111635,112392,111976,112132,111722,11,497
2020.01.02,87,410,11,down,508,308,164,75,down,547,pert,111797,111250,112143,111635,111722,111558,472,75
2020.01.03,308,164,75,down,547,75,322,86,up,483,gain,112054,111571,111797,111250,111646,111968,75,408
2020.01.06,75,322,86,Up,483,191,434,15,down,640,gain,111975,111335,112054,111571,111960,111526,15,625
2020.01.07,191,434,15,down,640,37,476,152,down,665,pert,111681,111016,111975,111335,111529,111053,513,152
2020.01.08,37,476,152,down,665,128,2,150,down,280,pert,111203,110923,111681,111016,111053,111051,130,150
2020.01.09,128,2,150,down,280,201,161,79,up,441,gain,111291,110850,111203,110923,111051,111212,201,240
2020.01.10,201,161,79,Up,441,35,176,131,up,342,pert,111469,111127,111291,110850,111162,111338,307,35
2020.01.13,35,176,131,Up,342,232,64,106,down,402,gain,111444,111042,111469,111127,111338,111274,106,296
2020.01.14,232,64,106,down,402,99,211,138,up,448,gain,111633,111185,111444,111042,111284,111495,99,349
2020.01.15,99,211,138,Up,448,80,134,234,down,448,gain,111726,111278,111633,111185,111492,111358,234,214
2020.01.16,80,134,234,down,448,31,459,73,down,563,pert,111425,110862,111726,111278,111352,110893,490,73
2020.01.17,31,459,73,down,563,154,24,80,up,258,gain,111024,110766,111425,110862,110920,110944,154,104
2020.01.20,154,24,80,Up,258,10,115,246,down,371,gain,111180,110809,111024,110766,110934,110819,246,125
2020.01.21,10,115,246,down,371,115,104,63,up,282,gain,110983,110701,111180,110809,110816,110920,115,167
2020.01.22,115,104,63,Up,282,179,378,167,down,724,gain,111087,110363,110983,110701,110920,110542,167,557
2020.01.23,179,378,167,down,724,59,287,75,down,421,pert,110617,110196,111087,110363,110542,110255,346,75
2020.01.24,59,287,75,down,421,88,111,80,down,279,pert,110375,110096,110617,110196,110295,110184,199,80
2020.01.27,88,111,80,down,279,208,35,31,up,274,gain,110251,109977,110375,110096,110185,110220,208,66
2020.01.28,208,35,31,Up,274,177,120,58,down,355,gain,110277,109922,110251,109977,110219,110099,58,297
2020.01.29,177,120,58,down,355,30,214,81,up,325,gain,110393,110068,110277,109922,110098,110312,30,295
2020.01.30,30,214,81,Up,325,145,630,8,up,783,pert,110951,110168,110393,110068,110313,110943,638,145
2020.01.31,145,630,8,Up,783,244,314,20,down,578,gain,110927,110349,110951,110168,110907,110593,20,558
2020.02.03,244,314,20,down,578,107,156,52,down,315,pert,110642,110327,110927,110349,110590,110434,263,52
2020.02.04,107,156,52,down,315,54,447,42,down,543,pert,110478,109935,110642,110327,110436,109989,501,42
2020.02.05,54,447,42,down,543,184,162,149,down,495,pert,110138,109643,110478,109935,109989,109827,346,149
2020.02.06,184,162,149,down,495,12,397,22,down,431,pert,109849,109418,110138,109643,109827,109430,409,22
2020.02.07,12,397,22,down,431,29,319,150,down,498,pert,109574,109076,109849,109418,109424,109105,348,150
2020.02.10,29,319,150,down,498,193,40,102,up,335,gain,109247,108912,109574,109076,109105,109145,193,142
2020.02.11,193,40,102,Up,335,77,418,109,down,604,gain,109255,108651,109247,108912,109146,108728,109,495
2020.02.12,77,418,109,down,604,69,308,171,down,548,pert,108887,108339,109255,108651,108716,108408,377,171
2020.02.13,69,308,171,down,548,29,107,204,down,340,pert,108612,108272,108887,108339,108408,108301,136,204
2020.02.14,29,107,204,down,340,55,51,112,down,218,pert,108509,108291,108612,108272,108397,108346,106,112
2020.02.17,55,51,112,down,218,55,438,27,down,520,pert,108372,107852,108509,108291,108345,107907,493,27
2020.02.18,55,438,27,down,520,85,133,78,up,296,gain,108117,107821,108372,107852,107906,108039,85,211
2020.02.19,85,133,78,Up,296,63,195,178,down,436,gain,108211,107775,108117,107821,108033,107838,178,258
2020.02.20,63,195,178,down,436,6,633,160,up,799,gain,108634,107835,108211,107775,107841,108474,6,793
2020.02.21,6,633,160,Up,799,201,270,200,up,671,pert,108720,108049,108634,107835,108250,108520,470,201
2020.02.24,201,270,200,Up,671,219,287,95,up,601,pert,108901,108300,108720,108049,108519,108806,382,219
2020.02.25,219,287,95,Up,601,257,1,280,up,538,pert,109087,108549,108901,108300,108806,108807,281,257
2020.02.26,257,1,280,Up,538,41,1186,68,up,1295,pert,110066,108771,109087,108549,108812,109998,1254,41
2020.02.27,41,1186,68,Up,1295,490,295,238,up,1023,pert,110531,109508,110066,108771,109998,110293,533,490
2020.02.28,490,295,238,Up,1023,45,925,513,up,1483,pert,111845,110362,110531,109508,110407,111332,1438,45
2020.03.02,45,925,513,Up,1483,363,396,420,up,1179,pert,112130,110951,111845,110362,111314,111710,816,363
2020.03.03,363,396,420,Up,1179,383,371,168,down,922,gain,111875,110953,112130,110951,111707,111336,168,754
2020.03.04,383,371,168,down,922,145,1031,76,up,1252,gain,112447,111195,111875,110953,111340,112371,145,1107
2020.03.05,145,1031,76,Up,1252,257,531,645,up,1433,pert,113546,112113,112447,111195,112370,112901,1176,257
2020.03.06,257,531,645,Up,1433,72,889,606,up,1567,pert,114964,113397,113546,112113,113469,114358,1495,72
2020.03.09,72,889,606,Up,1567,162,1453,216,down,1831,gain,114574,112743,114964,113397,114358,112905,216,1615
2020.03.10,162,1453,216,down,1831,107,298,757,down,1162,pert,113662,112500,114574,112743,112905,112607,405,757
2020.03.11,107,298,757,down,1162,1113,935,730,down,2778,pert,113332,110554,113662,112500,112602,111667,2048,730
2020.03.12,1113,935,730,down,2778,476,661,525,down,1662,pert,112211,110549,113332,110554,111686,111025,1137,525
2020.03.13,476,661,525,down,1662,931,109,478,down,1518,pert,112364,110846,112211,110549,111886,111777,1040,478
2020.03.16,931,109,478,down,1518,502,1725,113,down,2340,pert,111890,109550,112364,110846,111777,110052,2227,113
2020.03.17,502,1725,113,down,2340,1100,945,389,down,2434,pert,110450,108016,111890,109550,110061,109116,2045,389
2020.03.18,1100,945,389,down,2434,48,2528,700,down,3276,pert,109817,106541,110450,108016,109117,106589,2576,700
2020.03.19,48,2528,700,down,3276,239,321,1374,up,1934,gain,108309,106375,109817,106541,106614,106935,239,1695
2020.03.20,239,321,1374,Up,1934,582,320,1017,up,1919,pert,108274,106355,108309,106375,106937,107257,1337,582
2020.03.23,582,320,1017,Up,1919,0,599,1055,up,1654,pert,108880,107226,108274,106355,107226,107825,1654,0
2020.03.24,0,599,1055,Up,1654,222,973,143,up,1338,pert,108939,107601,108880,107226,107823,108796,1116,222
2020.03.25,222,973,143,Up,1338,97,1494,295,up,1886,pert,110586,108700,108939,107601,108797,110291,1789,97
2020.03.26,97,1494,295,Up,1886,757,1141,39,up,1937,pert,111470,109533,110586,108700,110290,111431,1180,757
2020.03.27,757,1141,39,Up,1937,328,732,280,down,1340,gain,111439,110099,111470,109533,111159,110427,280,1060
2020.03.30,328,732,280,down,1340,1083,65,123,down,1271,pert,110537,109266,111439,110099,110414,110349,1148,123
2020.03.31,1083,65,123,down,1271,589,683,91,down,1363,pert,110390,109027,110537,109266,110299,109616,1272,91
2020.04.01,589,683,91,down,1363,363,1051,59,down,1473,pert,109678,108205,110390,109027,109619,108568,1414,59
2020.04.02,363,1051,59,down,1473,400,423,91,down,914,pert,108641,107727,109678,108205,108550,108127,823,91
2020.04.03,400,423,91,down,914,238,168,266,down,672,pert,108354,107682,108641,107727,108088,107920,406,266
2020.04.06,238,168,266,down,672,86,984,355,up,1425,gain,109259,107834,108354,107682,107920,108904,86,1339
2020.04.07,86,984,355,Up,1425,267,338,117,down,722,gain,109020,108298,109259,107834,108903,108565,117,605
2020.04.08,267,338,117,down,722,150,726,230,up,1106,gain,109515,108409,109020,108298,108559,109285,150,956
2020.04.09,150,726,230,Up,1106,101,61,175,up,337,pert,109522,109185,109515,108409,109286,109347,236,101
2020.04.10,101,61,175,Up,337,195,308,248,down,751,gain,109676,108925,109522,109185,109428,109120,248,503
2020.04.13,195,308,248,down,751,133,678,72,up,883,gain,109870,108987,109676,108925,109120,109798,133,750
2020.04.14,133,678,72,Up,883,504,728,113,down,1345,gain,109907,108562,109870,108987,109794,109066,113,1232
2020.04.15,504,728,113,down,1345,220,690,35,down,945,pert,109111,108166,109907,108562,109076,108386,910,35
2020.04.16,220,690,35,down,945,267,353,186,up,806,gain,108925,108119,109111,108166,108386,108739,267,539
2020.04.17,267,353,186,Up,806,196,18,340,down,554,gain,108965,108411,108925,108119,108625,108607,340,214
2020.04.20,196,18,340,down,554,400,47,190,down,637,pert,108801,108164,108965,108411,108611,108564,447,190
2020.04.21,400,47,190,down,637,197,334,288,down,819,pert,108851,108032,108801,108164,108563,108229,531,288
2020.04.22,197,334,288,down,819,200,466,240,down,906,pert,108466,107560,108851,108032,108226,107760,666,240
2020.04.23,200,466,240,down,906,491,484,13,up,988,gain,108257,107269,108466,107560,107760,108244,491,497
2020.04.24,491,484,13,Up,988,96,72,322,up,490,pert,108602,108112,108257,107269,108208,108280,394,96
2020.04.27,96,72,322,Up,490,86,93,608,down,787,gain,108883,108096,108602,108112,108275,108182,608,179
2020.04.28,86,93,608,down,787,1,548,127,up,676,gain,108855,108179,108883,108096,108180,108728,1,675
2020.04.29,1,548,127,Up,676,381,798,217,up,1396,pert,109724,108328,108855,108179,108709,109507,1015,381
2020.04.30,381,798,217,Up,1396,142,317,378,up,837,pert,110180,109343,109724,108328,109485,109802,695,142
2020.05.01,142,317,378,Up,837,109,619,59,down,787,gain,109743,108956,110180,109343,109684,109065,59,728
2020.05.04,109,619,59,down,787,133,664,203,down,1000,pert,109257,108257,109743,108956,109054,108390,797,203
2020.05.05,133,664,203,down,1000,111,468,57,down,636,pert,108454,107818,109257,108257,108397,107929,579,57
2020.05.06,111,468,57,down,636,261,394,20,up,675,gain,108339,107664,108454,107818,107925,108319,261,414
2020.05.07,261,394,20,Up,675,165,71,369,up,605,pert,108755,108150,108339,107664,108315,108386,440,165
2020.05.08,165,71,369,Up,605,55,180,263,down,498,gain,108503,108005,108755,108150,108240,108060,263,235
2020.05.11,55,180,263,down,498,195,431,383,up,1009,gain,108852,107843,108503,108005,108038,108469,195,814
2020.05.12,195,431,383,Up,1009,58,291,499,down,848,gain,108963,108115,108852,107843,108464,108173,499,349
2020.05.13,58,291,499,down,848,294,125,71,down,490,pert,108238,107748,108963,108115,108167,108042,419,71
2020.05.14,294,125,71,down,490,143,156,318,up,617,gain,108505,107888,108238,107748,108031,108187,143,474
2020.05.15,143,156,318,Up,617,16,1125,130,up,1271,pert,109269,107998,108505,107888,108014,109139,1255,16
2020.05.18,16,1125,130,Up,1271,124,72,542,up,738,pert,109759,109021,109269,107998,109145,109217,614,124
2020.05.19,124,72,542,Up,738,43,559,222,up,824,pert,109989,109165,109759,109021,109208,109767,781,43
2020.05.20,43,559,222,Up,824,104,285,321,down,710,gain,110082,109372,109989,109165,109761,109476,321,389
2020.05.21,104,285,321,down,710,170,436,78,down,684,pert,109536,108852,110082,109372,109458,109022,606,78
2020.05.22,170,436,78,down,684,247,3,188,up,438,gain,109144,108706,109536,108852,108953,108956,247,191
2020.05.25,247,3,188,Up,438,3,896,140,up,1039,pert,109958,108919,109144,108706,108922,109818,1036,3
2020.05.26,3,896,140,Up,1039,475,212,280,up,967,pert,110306,109339,109958,108919,109814,110026,492,475
2020.05.27,475,212,280,Up,967,45,795,177,up,1017,pert,110934,109917,110306,109339,109962,110757,972,45
2020.05.28,45,795,177,Up,1017,87,320,374,up,781,pert,111450,110669,110934,109917,110756,111076,694,87
2020.05.29,87,320,374,Up,781,147,193,193,up,533,pert,111536,111003,111450,110669,111150,111343,386,147
2020.06.01,147,193,193,Up,533,191,343,272,up,806,pert,111957,111151,111536,111003,111342,111685,615,191
2020.06.02,191,343,272,Up,806,13,655,243,up,911,pert,112576,111665,111957,111151,111678,112333,898,13
2020.06.03,13,655,243,Up,911,374,1044,256,up,1674,pert,113621,111947,112576,111665,112321,113365,1300,374
2020.06.04,374,1044,256,Up,1674,92,493,470,down,1055,gain,113837,112782,113621,111947,113367,112874,470,585
2020.06.05,92,493,470,down,1055,0,0,0,NA,513,NA,113195,112682,113837,112782,0,0,0,0
2020.06.08,2,0,0,NA,513,0,456,0,NA,1226,NA,113635,112409,113195,112682,0,0,0,0
2020.06.09,524,456,246,Up,1226,173,335,499,up,1007,pert,114222,113215,113635,112409,113388,113723,834,173
2020.06.10,173,335,499,Up,1007,95,742,312,down,1149,gain,114035,112886,114222,113215,113723,112981,312,837
2020.06.11,95,742,312,down,1149,479,329,469,down,1277,pert,113402,112125,114035,112886,112933,112604,808,469
2020.06.12,479,329,469,down,1277,93,866,101,up,1060,gain,113323,112263,113402,112125,112356,113222,93,967
2020.06.15,93,866,101,Up,1060,357,587,311,down,1255,gain,113531,112276,113323,112263,113220,112633,311,944
2020.06.16,357,587,311,down,1255,356,202,311,down,869,pert,112939,112070,113531,112276,112628,112426,558,311
2020.06.17,356,202,311,down,869,195,379,184,down,758,pert,112612,111854,112939,112070,112428,112049,574,184
2020.06.18,195,379,184,down,758,84,282,495,down,861,pert,112542,111681,112612,111854,112047,111765,366,495
2020.06.19,84,282,495,down,861,135,774,104,up,1013,gain,112697,111684,112542,111681,111819,112593,135,878
2020.06.22,135,774,104,Up,1013,262,482,409,up,1153,pert,113483,112330,112697,111684,112592,113074,891,262
2020.06.23,262,482,409,Up,1153,20,570,184,down,774,gain,113257,112483,113483,112330,113073,112503,184,590
2020.06.24,20,570,184,down,774,268,333,92,down,693,pert,112595,111902,113257,112483,112503,112170,601,92
2020.06.25,268,333,92,down,693,228,2,210,down,440,pert,112391,111951,112595,111902,112181,112179,230,210
2020.06.29,0,264,466,Up,730,427,76,204,down,707,gain,112616,111909,112876,112146,112412,112336,204,503
2020.06.30,427,76,204,down,707,493,167,242,up,902,gain,112749,111847,112616,111909,112340,112507,493,409
2020.07.01,493,167,242,Up,902,157,119,518,down,794,gain,113025,112231,112749,111847,112507,112388,518,276
2020.07.02,157,119,518,down,794,199,91,42,up,332,gain,112524,112192,113025,112231,112391,112482,199,133
2020.07.03,199,91,42,Up,332,24,655,370,up,1049,pert,113455,112406,112524,112192,112430,113085,1025,24
2020.07.06,24,655,370,Up,1049,140,357,239,down,736,gain,113323,112587,113455,112406,113084,112727,239,497
2020.07.07,140,357,239,down,736,53,618,223,up,894,gain,113515,112621,113323,112587,112674,113292,53,841
2020.07.08,53,618,223,Up,894,45,441,419,down,905,gain,113706,112801,113515,112621,113287,112846,419,486
2020.07.09,45,441,419,down,905,297,120,282,up,699,gain,113247,112548,113706,112801,112845,112965,297,402
2020.07.10,297,120,282,Up,699,7,420,313,up,740,pert,113748,113008,113247,112548,113015,113435,733,7
2020.07.13,7,420,313,Up,740,181,562,92,up,835,pert,114085,113250,113748,113008,113431,113993,654,181
2020.07.14,181,562,92,Up,835,80,124,404,up,608,pert,114518,113910,114085,113250,113990,114114,528,80
2020.07.15,80,124,404,Up,608,131,279,306,down,716,gain,114419,113703,114518,113910,114113,113834,306,410
2020.07.16,131,279,306,down,716,87,426,179,up,692,gain,114437,113745,114419,113703,113832,114258,87,605
2020.07.17,87,426,179,Up,692,21,430,204,up,655,pert,114676,114021,114437,113745,114042,114472,634,21
2020.07.20,21,430,204,Up,655,243,795,131,up,1169,pert,115396,114227,114676,114021,114470,115265,926,243
2020.07.21,243,795,131,Up,1169,202,427,314,up,943,pert,116009,115066,115396,114227,115268,115695,741,202
2020.07.22,202,427,314,Up,943,291,266,307,up,864,pert,116266,115402,116009,115066,115693,115959,573,291
2020.07.23,291,266,307,Up,864,144,592,27,up,763,pert,116576,115813,116266,115402,115957,116549,619,144
2020.07.24,144,592,27,Up,763,19,1079,301,up,1399,pert,117811,116412,116576,115813,116431,117510,1380,19
2020.07.27,19,1079,301,Up,1399,164,362,223,down,749,gain,117735,116986,117811,116412,117512,117150,223,526
2020.07.28,164,362,223,down,749,22,758,153,up,933,gain,118059,117126,117735,116986,117148,117906,22,911
2020.07.29,22,758,153,Up,933,603,557,13,up,1173,pert,118480,117307,118059,117126,117910,118467,570,603
2020.07.30,603,557,13,Up,1173,100,752,621,down,1473,gain,119086,117613,118480,117307,118465,117713,621,852
2020.07.31,100,752,621,down,1473,660,80,269,down,1009,pert,117966,116957,119086,117613,117697,117617,740,269
2020.08.03,660,80,269,down,1009,421,395,32,up,848,gain,118060,117212,117966,116957,117633,118028,421,427
2020.08.04,421,395,32,Up,848,97,603,418,up,1118,pert,119047,117929,118060,117212,118026,118629,1021,97
2020.08.05,97,603,418,Up,1118,449,135,398,up,982,pert,119160,118178,119047,117929,118627,118762,533,449
2020.08.06,449,135,398,Up,982,304,909,64,down,1277,gain,118827,117550,119160,118178,118763,117854,64,1213
2020.08.07,304,909,64,down,1277,12,493,142,down,647,pert,118006,117359,118827,117550,117864,117371,505,142
2020.08.10,12,493,142,down,647,153,22,679,up,854,gain,118074,117220,118006,117359,117373,117395,153,701
2020.08.11,153,22,679,Up,854,293,433,330,up,1056,pert,118165,117109,118074,117220,117402,117835,763,293
2020.08.12,293,433,330,Up,1056,39,296,509,up,844,pert,118640,117796,118165,117109,117835,118131,805,39
2020.08.13,39,296,509,Up,844,312,287,90,up,689,pert,118503,117814,118640,117796,118126,118413,377,312
2020.08.14,312,287,90,Up,689,92,321,112,up,525,pert,118810,118285,118503,117814,118377,118698,433,92
2020.08.17,92,321,112,Up,525,40,611,350,up,1001,pert,119656,118655,118810,118285,118695,119306,961,40
2020.08.18,40,611,350,Up,1001,84,917,224,down,1225,gain,119526,118301,119656,118655,119302,118385,224,1001
2020.08.19,84,917,224,down,1225,335,244,86,up,665,gain,118685,118020,119526,118301,118355,118599,335,330
2020.08.20,335,244,86,Up,665,422,635,228,down,1285,gain,118827,117542,118685,118020,118599,117964,228,1057
2020.08.21,422,635,228,down,1285,32,56,567,down,655,pert,118496,117841,118827,117542,117929,117873,88,567
2020.08.24,32,56,567,down,655,31,472,93,up,596,gain,118436,117840,118496,117841,117871,118343,31,565
2020.08.28,105,840,141,Up,1086,197,325,299,up,821,pert,119660,118839,119196,118110,119036,119361,624,197
2020.08.31,197,325,299,Up,821,102,245,750,down,1097,gain,120108,119011,119660,118839,119358,119113,750,347
2020.09.01,102,245,750,down,1097,327,565,173,down,1065,pert,119285,118220,120108,119011,119112,118547,892,173
2020.09.02,327,565,173,down,1065,625,9,124,down,758,pert,118645,117887,119285,118220,118521,118512,634,124
2020.09.03,625,9,124,down,758,586,119,139,down,844,pert,118652,117808,118645,117887,118513,118394,705,139
2020.09.04,586,119,139,down,844,25,322,27,down,374,pert,118485,118111,118652,117808,118458,118136,347,27
2020.09.07,25,322,27,down,374,85,397,137,down,619,pert,118273,117654,118485,118111,118136,117739,482,137
2020.09.08,85,397,137,down,619,219,280,310,up,809,gain,118337,117528,118273,117654,117747,118027,219,590
2020.09.09,219,280,310,Up,809,32,120,1028,up,1180,pert,119174,117994,118337,117528,118026,118146,1148,32
2020.09.10,32,120,1028,Up,1180,59,314,280,up,653,pert,118739,118086,119174,117994,118145,118459,594,59
2020.09.11,59,314,280,Up,653,41,281,237,up,559,pert,118880,118321,118739,118086,118362,118643,518,41
2020.09.14,41,281,237,Up,559,69,186,356,down,611,gain,119004,118393,118880,118321,118648,118462,356,255
2020.09.15,69,186,356,down,611,282,310,361,down,953,pert,118826,117873,119004,118393,118465,118155,592,361
2020.09.16,282,310,361,down,953,772,330,47,up,1149,gain,118523,117374,118826,117873,118146,118476,772,377
2020.09.17,772,330,47,Up,1149,155,63,227,down,445,gain,118703,118258,118523,117374,118476,118413,227,218
2020.09.18,155,63,227,down,445,391,748,262,down,1401,pert,118717,117316,118703,118258,118455,117707,1139,262
2020.09.21,391,748,262,down,1401,161,623,35,down,819,pert,117735,116916,118717,117316,117700,117077,784,35
2020.09.22,161,623,35,down,819,84,479,115,down,678,pert,117189,116511,117735,116916,117074,116595,563,115
2020.09.23,84,479,115,down,678,326,118,160,up,604,gain,116868,116264,117189,116511,116590,116708,326,278
2020.09.24,326,118,160,Up,604,174,410,143,down,727,gain,116849,116122,116868,116264,116706,116296,143,584
2020.09.25,174,410,143,down,727,71,428,149,up,648,gain,116799,116151,116849,116122,116222,116650,71,577
2020.09.28,71,428,149,Up,648,41,776,29,up,846,pert,117455,116609,116799,116151,116650,117426,805,41
2020.09.29,41,776,29,Up,846,364,220,117,down,701,gain,117547,116846,117455,116609,117430,117210,117,584
2020.09.30,364,220,117,down,701,39,255,229,up,523,gain,117694,117171,117547,116846,117210,117465,39,484
2020.10.01,39,255,229,Up,523,208,324,0,down,532,gain,117489,116957,117694,117171,117489,117165,0,532
2020.10.02,208,324,0,down,532,78,694,149,up,921,gain,117974,117053,117489,116957,117131,117825,78,843
2020.10.05,78,694,149,Up,921,18,492,250,down,760,gain,118076,117316,117974,117053,117826,117334,250,510
2020.10.06,18,492,250,down,760,87,293,190,up,570,gain,117818,117248,118076,117316,117335,117628,87,483
2020.10.07,87,293,190,Up,570,258,42,192,down,492,gain,117816,117324,117818,117248,117624,117582,192,300
2020.10.08,258,42,192,down,492,36,706,11,up,753,gain,118304,117551,117816,117324,117587,118293,36,717
2020.10.09,36,706,11,Up,753,254,53,92,down,399,gain,118265,117866,118304,117551,118173,118120,92,307
2020.10.12,254,53,92,down,399,141,674,35,down,850,pert,118155,117305,118265,117866,118120,117446,815,35
2020.10.13,141,674,35,down,850,0,0,0,NA,517,NA,117712,117195,118155,117305,0,0,0,0
2020.10.14,2,0,0,NA,517,0,379,0,NA,694,NA,117576,116882,117712,117195,0,0,0,0
2020.10.15,191,379,124,down,694,134,87,300,up,521,gain,117460,116939,117576,116882,117073,117160,134,387
2020.10.16,134,87,300,Up,521,165,500,241,up,906,pert,117936,117030,117460,116939,117195,117695,741,165
2020.10.19,165,500,241,Up,906,97,516,196,up,809,pert,118407,117598,117936,117030,117695,118211,712,97
2020.10.20,97,516,196,Up,809,6,384,208,up,598,pert,118806,118208,118407,117598,118214,118598,592,6
2020.10.21,6,384,208,Up,598,63,405,85,down,553,gain,118667,118114,118806,118208,118582,118177,85,468
2020.10.22,63,405,85,down,553,310,421,48,up,779,gain,118646,117867,118667,118114,118177,118598,310,469
2020.10.23,310,421,48,Up,779,56,464,3,down,523,gain,118554,118031,118646,117867,118551,118087,3,520
2020.10.26,56,464,3,down,523,52,217,300,down,569,pert,118387,117818,118554,118031,118087,117870,269,300
2020.10.27,52,217,300,down,569,273,419,9,down,701,pert,117879,117178,118387,117818,117870,117451,692,9
2020.10.28,273,419,9,down,701,241,711,135,down,1087,pert,117586,116499,117879,117178,117451,116740,952,135
2020.10.29,241,711,135,down,1087,64,279,299,down,642,pert,117040,116398,117586,116499,116741,116462,343,299
2020.10.30,64,279,299,down,642,183,64,88,down,335,pert,116556,116221,117040,116398,116468,116404,247,88
2020.11.02,183,64,88,down,335,83,744,246,up,1073,gain,117396,116323,116556,116221,116406,117150,83,990
2020.11.03,83,744,246,Up,1073,1131,94,460,up,1685,pert,117704,116019,117396,116323,117150,117244,554,1131
2020.11.04,1131,94,460,Up,1685,136,1023,331,up,1490,pert,118598,117108,117704,116019,117244,118267,1354,136
2020.11.05,136,1023,331,Up,1490,318,474,163,up,955,pert,118909,117954,118598,117108,118272,118746,637,318
2020.11.06,318,474,163,Up,955,176,746,327,down,1249,gain,119200,117951,118909,117954,118873,118127,327,922
2020.11.09,176,746,327,down,1249,326,12,296,up,634,gain,118432,117798,119200,117951,118124,118136,326,308
2020.11.10,326,12,296,Up,634,316,367,190,down,873,gain,118328,117455,118432,117798,118138,117771,190,683
2020.11.11,316,367,190,down,873,185,277,183,up,645,gain,118231,117586,118328,117455,117771,118048,185,460
2020.11.12,185,277,183,Up,645,58,279,46,up,383,pert,118372,117989,118231,117586,118047,118326,325,58
2020.11.13,58,279,46,Up,383,259,116,172,up,547,pert,118688,118141,118372,117989,118400,118516,288,259
2020.11.16,259,116,172,Up,547,81,96,334,up,511,pert,118939,118428,118688,118141,118509,118605,430,81
2020.11.17,81,96,334,Up,511,35,92,292,down,419,gain,118910,118491,118939,118428,118618,118526,292,127
2020.11.18,35,92,292,down,419,363,219,80,up,662,gain,118825,118163,118910,118491,118526,118745,363,299
2020.11.19,363,219,80,Up,662,90,158,164,down,412,gain,118909,118497,118825,118163,118745,118587,164,248
2020.11.20,90,158,164,down,412,399,97,565,down,1061,pert,119061,118000,118909,118497,118496,118399,496,565
2020.11.23,399,97,565,down,1061,41,505,55,up,601,gain,118959,118358,119061,118000,118399,118904,41,560
2020.11.24,41,505,55,Up,601,86,252,141,up,479,pert,119298,118819,118959,118358,118905,119157,393,86
2020.11.25,86,252,141,Up,479,274,37,245,down,556,gain,119409,118853,119298,118819,119164,119127,245,311
2020.11.26,274,37,245,down,556,58,468,37,up,563,gain,119630,119067,119409,118853,119125,119593,58,505
2020.11.27,58,468,37,Up,563,20,344,434,down,798,gain,120034,119236,119630,119067,119600,119256,434,364
2020.11.30,20,344,434,down,798,8,1431,74,up,1513,gain,120766,119253,120034,119236,119261,120692,8,1505
2020.12.01,8,1431,74,Up,1513,291,445,48,up,784,pert,121184,120400,120766,119253,120691,121136,493,291
2020.12.02,291,445,48,Up,784,126,332,277,up,735,pert,121746,121011,121184,120400,121137,121469,609,126
2020.12.03,126,332,277,Up,735,101,246,326,down,673,gain,121773,121100,121746,121011,121447,121201,326,347
2020.12.04,101,246,326,down,673,304,208,365,down,877,pert,121664,120787,121773,121100,121299,121091,512,365
2020.12.07,304,208,365,down,877,66,69,249,down,384,pert,121340,120956,121664,120787,121091,121022,135,249
2020.12.08,66,69,249,down,384,217,220,452,down,889,pert,121474,120585,121340,120956,121022,120802,437,452
2020.12.09,217,220,452,down,889,51,609,190,up,850,gain,121588,120738,121474,120585,120789,121398,51,799
2020.12.10,51,609,190,Up,850,71,236,267,down,574,gain,121628,121054,121588,120738,121361,121125,267,307
2020.12.11,71,236,267,down,574,210,66,334,up,610,gain,121766,121156,121628,121054,121366,121432,210,400
2020.12.14,210,66,334,Up,610,218,73,182,up,473,pert,121687,121214,121766,121156,121432,121505,255,218
2020.12.15,218,73,182,Up,473,240,495,140,up,875,pert,122124,121249,121687,121214,121489,121984,635,240
2020.12.16,240,495,140,Up,875,88,699,45,up,832,pert,122729,121897,122124,121249,121985,122684,744,88
2020.12.17,88,699,45,Up,832,286,134,43,down,463,gain,122719,122256,122729,121897,122676,122542,43,420
2020.12.18,286,134,43,down,463,870,258,104,up,1232,gain,122528,121296,122719,122256,122166,122424,870,362
2020.12.21,870,258,104,Up,1232,96,818,139,down,1053,gain,122573,121520,122528,121296,122434,121616,139,914
2020.12.22,96,818,139,down,1053,78,242,352,up,672,gain,122212,121540,122573,121520,121618,121860,78,594
2020.12.23,78,242,352,Up,672,34,49,300,down,383,gain,122157,121774,122212,121540,121857,121808,300,83
2020.12.24,34,49,300,down,383,0,464,346,up,810,gain,122506,121696,122157,121774,121696,122160,0,810
2020.12.28,0,464,346,Up,810,90,322,267,up,679,pert,122749,122070,122506,121696,122160,122482,589,90
2020.12.30,1,490,138,Up,629,28,808,130,down,966,gain,123093,122127,123099,122470,122963,122155,130,836
2020.12.31,28,808,130,down,966,115,78,625,up,818,gain,123098,122280,123093,122127,122395,122473,115,703
2021.01.04,115,78,625,Up,818,34,499,91,up,624,pert,123056,122432,123098,122280,122466,122965,590,34
2021.01.05,34,499,91,Up,624,311,284,242,up,837,pert,123494,122657,123056,122432,122968,123252,526,311
2021.01.06,311,284,242,Up,837,258,546,185,down,989,gain,123441,122452,123494,122657,123256,122710,185,804
2021.01.07,258,546,185,down,989,286,495,132,down,913,pert,122845,121932,123441,122452,122713,122218,781,132
2021.01.08,286,495,132,down,913,174,619,169,down,962,pert,122285,121323,122845,121932,122116,121497,793,169
2021.01.11,174,619,169,down,962,126,564,35,up,725,gain,122097,121372,122285,121323,121498,122062,126,599
2021.01.12,126,564,35,Up,725,169,496,165,down,830,gain,122229,121399,122097,121372,122064,121568,165,665
2021.01.13,169,496,165,down,830,428,28,216,down,672,pert,121784,121112,122229,121399,121568,121540,456,216
2021.01.14,428,28,216,down,672,16,771,88,down,875,pert,121625,120750,121784,121112,121537,120766,787,88
2021.01.15,16,771,88,down,875,221,56,54,down,331,pert,120867,120536,121625,120750,120813,120757,277,54
2021.01.18,221,56,54,down,331,29,516,165,up,710,gain,121449,120739,120867,120536,120768,121284,29,681
2021.01.19,29,516,165,Up,710,279,235,301,down,815,gain,121582,120767,121449,120739,121281,121046,301,514
2021.01.20,279,235,301,down,815,21,597,92,up,710,gain,121732,121022,121582,120767,121043,121640,21,689
2021.01.21,21,597,92,Up,710,71,118,190,up,379,pert,121894,121515,121732,121022,121586,121704,308,71
2021.01.22,71,118,190,Up,379,253,291,129,down,673,gain,121833,121160,121894,121515,121704,121413,129,544
2021.01.25,253,291,129,down,673,293,221,168,up,682,gain,121760,121078,121833,121160,121371,121592,293,389
2021.01.26,293,221,168,Up,682,510,502,98,down,1110,gain,121696,120586,121760,121078,121598,121096,98,1012
2021.01.27,510,502,98,down,1110,281,124,211,up,616,gain,121421,120805,121696,120586,121086,121210,281,335
2021.01.28,281,124,211,Up,616,265,144,205,up,614,pert,121558,120944,121421,120805,121209,121353,349,265
2021.01.29,265,144,205,Up,614,32,707,63,down,802,gain,121364,120562,121558,120944,121301,120594,63,739
2021.02.01,32,707,63,down,802,311,166,282,down,759,pert,120876,120117,121364,120562,120594,120428,477,282
2021.02.02,311,166,282,down,759,309,72,77,down,458,pert,120500,120042,120876,120117,120423,120351,381,77
2021.02.03,309,72,77,down,458,46,729,79,down,854,pert,120428,119574,120500,120042,120349,119620,775,79
2021.02.04,46,729,79,down,854,96,874,6,up,976,gain,120498,119522,120428,119574,119618,120492,96,880
2021.02.05,96,874,6,Up,976,229,67,168,up,464,pert,120661,120197,120498,119522,120426,120493,235,229
2021.02.08,229,67,168,Up,464,21,681,47,up,749,pert,121221,120472,120661,120197,120493,121174,728,21
2021.02.09,21,681,47,Up,749,84,1,267,down,352,gain,121440,121088,121221,120472,121173,121172,267,85
2021.02.10,84,1,267,down,352,37,131,190,up,358,gain,121493,121135,121440,121088,121172,121303,37,321
2021.02.11,37,131,190,Up,358,374,114,46,down,534,gain,121349,120815,121493,121135,121303,121189,46,488
2021.02.12,374,114,46,down,534,73,34,178,up,285,gain,121452,121167,121349,120815,121240,121274,73,212
2021.02.15,73,34,178,Up,285,104,218,423,down,745,gain,121694,120949,121452,121167,121271,121053,423,322
2021.02.16,104,218,423,down,745,140,673,42,down,855,pert,121089,120234,121694,120949,121047,120374,813,42
2021.02.17,140,673,42,down,855,1,557,36,up,594,gain,120944,120350,121089,120234,120351,120908,1,593
2021.02.18,1,557,36,Up,594,85,266,269,up,620,pert,121443,120823,120944,120350,120908,121174,535,85
2021.02.19,85,266,269,Up,620,219,423,140,up,782,pert,121694,120912,121443,120823,121131,121554,563,219
2021.02.22,219,423,140,Up,782,140,71,238,down,449,gain,121802,121353,121694,120912,121564,121493,238,211
2021.02.23,140,71,238,down,449,401,172,80,up,653,gain,121745,121092,121802,121353,121493,121665,401,252
2021.02.24,401,172,80,Up,653,77,106,689,up,872,pert,122432,121560,121745,121092,121637,121743,795,77
2021.02.25,77,106,689,Up,872,105,1003,98,down,1206,gain,121828,120622,122432,121560,121730,120727,98,1108
2021.02.26,105,1003,98,down,1206,210,200,324,down,734,pert,121012,120278,121828,120622,120688,120488,410,324
2021.03.01,210,200,324,down,734,573,405,51,up,1029,gain,120944,119915,121012,120278,120488,120893,573,456
2021.03.02,573,405,51,Up,1029,198,271,234,down,703,gain,121132,120429,120944,119915,120898,120627,234,469
2021.03.03,198,271,234,down,703,78,933,35,down,1046,pert,120662,119616,121132,120429,120627,119694,1011,35
2021.03.04,78,933,35,down,1046,192,560,87,down,839,pert,119767,118928,120662,119616,119680,119120,752,87
2021.03.05,192,560,87,down,839,18,706,155,down,879,pert,119321,118442,119767,118928,119166,118460,724,155
2021.03.08,18,706,155,down,879,100,545,156,up,801,gain,119157,118356,119321,118442,118456,119001,100,701
2021.03.09,100,545,156,Up,801,315,282,14,up,611,pert,119298,118687,119157,118356,119002,119284,296,315
2021.03.10,315,282,14,Up,611,125,568,49,up,742,pert,119900,119158,119298,118687,119283,119851,617,125
2021.03.11,125,568,49,Up,742,421,331,36,down,788,gain,119886,119098,119900,119158,119850,119519,36,752
2021.03.12,421,331,36,down,788,160,202,201,down,563,pert,119674,119111,119886,119098,119473,119271,362,201
2021.03.15,160,202,201,down,563,186,262,246,down,694,pert,119517,118823,119674,119111,119271,119009,448,246
2021.03.16,186,262,246,down,694,146,793,51,up,990,gain,119853,118863,119517,118823,119009,119802,146,844
2021.03.17,146,793,51,Up,990,73,667,88,down,828,gain,119890,119062,119853,118863,119802,119135,88,740
2021.03.18,73,667,88,down,828,306,90,238,down,634,pert,119372,118738,119890,119062,119134,119044,396,238
2021.03.19,306,90,238,down,634,84,504,135,up,723,gain,119467,118744,119372,118738,118828,119332,84,639
2021.03.22,84,504,135,Up,723,57,857,70,down,984,gain,119407,118423,119467,118744,119337,118480,70,914
2021.03.23,57,857,70,down,984,26,354,39,down,419,pert,118516,118097,119407,118423,118477,118123,380,39
2021.03.24,26,354,39,down,419,58,445,155,down,658,pert,118277,117619,118516,118097,118122,117677,503,155
2021.03.25,58,445,155,down,658,6,250,116,up,372,gain,118049,117677,118277,117619,117683,117933,6,366
2021.03.26,6,250,116,Up,372,34,244,51,down,329,gain,117937,117608,118049,117677,117886,117642,51,278
2021.03.29,34,244,51,down,329,55,471,96,down,622,pert,117736,117114,117937,117608,117640,117169,526,96
2021.03.30,55,471,96,down,622,129,128,300,up,557,gain,117598,117041,117736,117114,117170,117298,129,428
2021.03.31,129,128,300,Up,557,174,461,40,up,675,pert,117799,117124,117598,117041,117298,117759,501,174
2021.04.01,174,461,40,Up,675,120,152,104,down,376,gain,117864,117488,117799,117124,117760,117608,104,272
2021.04.02,120,152,104,down,376,161,582,71,up,814,gain,118196,117382,117864,117488,117543,118125,161,653
2021.04.05,161,582,71,Up,814,174,615,36,up,825,pert,118776,117951,118196,117382,118125,118740,651,174
2021.04.06,174,615,36,Up,825,59,62,417,down,538,gain,119147,118609,118776,117951,118730,118668,417,121
2021.04.07,59,62,417,down,538,61,458,149,up,668,gain,119273,118605,119147,118609,118666,119124,61,607
2021.04.08,61,458,149,Up,668,338,111,81,down,530,gain,119202,118672,119273,118605,119121,119010,81,449
2021.04.09,338,111,81,down,530,169,218,91,up,478,gain,119190,118712,119202,118672,118881,119099,169,309
2021.04.12,169,218,91,Up,478,318,381,86,up,785,pert,119560,118775,119190,118712,119093,119474,467,318
2021.04.13,318,381,86,Up,785,19,306,90,up,415,pert,119874,119459,119560,118775,119478,119784,396,19
2021.04.14,19,306,90,Up,415,94,126,152,down,372,gain,119933,119561,119874,119459,119781,119655,152,220
2021.04.15,94,126,152,down,372,150,155,140,up,445,gain,119949,119504,119933,119561,119654,119809,150,295
2021.04.16,150,155,140,Up,445,290,651,114,up,1055,pert,120481,119426,119949,119504,119716,120367,765,290
2021.04.19,290,651,114,Up,1055,119,21,434,down,574,gain,120798,120224,120481,119426,120364,120343,434,140
2021.04.20,119,21,434,down,574,0,0,0,NA,452,NA,120436,119984,120798,120224,0,0,0,0
2021.04.21,2,0,0,NA,452,0,205,0,NA,753,NA,120690,119937,120436,119984,0,0,0,0
2021.04.22,203,205,345,down,753,10,834,27,up,871,gain,121000,120129,120690,119937,120139,120973,10,861
2021.04.23,10,834,27,Up,871,228,81,248,down,557,gain,121170,120613,121000,120129,120922,120841,248,309
2021.04.26,228,81,248,down,557,286,38,36,up,360,gain,120928,120568,121170,120613,120854,120892,286,74
2021.04.27,286,38,36,Up,360,333,354,98,up,785,pert,121348,120563,120928,120568,120896,121250,452,333
2021.04.28,333,354,98,Up,785,166,62,253,down,481,gain,121502,121021,121348,120563,121249,121187,253,228
2021.04.29,166,62,253,down,481,42,982,76,down,1100,pert,121266,120166,121502,121021,121190,120208,1024,76
2021.04.30,42,982,76,down,1100,172,328,130,up,630,gain,120759,120129,121266,120166,120301,120629,172,458
2021.05.03,172,328,130,Up,630,129,509,11,down,649,gain,120641,119992,120759,120129,120630,120121,11,638
2021.05.04,129,509,11,down,649,176,82,150,down,408,pert,120268,119860,120641,119992,120118,120036,258,150
2021.05.05,176,82,150,down,408,105,610,70,up,785,gain,120716,119931,120268,119860,120036,120646,105,680
2021.05.06,105,610,70,Up,785,117,971,95,up,1183,pert,121713,120530,120716,119931,120647,121618,1066,117
2021.05.07,117,971,95,Up,1183,4,318,183,down,505,gain,121783,121278,121713,120530,121600,121282,183,322
2021.05.10,4,318,183,down,505,50,190,347,up,587,gain,121817,121230,121783,121278,121280,121470,50,537
2021.05.11,50,190,347,Up,587,49,767,49,down,865,gain,121521,120656,121817,121230,121472,120705,49,816
2021.05.12,49,767,49,down,865,209,67,270,up,546,gain,121061,120515,121521,120656,120724,120791,209,337
2021.05.13,209,67,270,Up,546,79,654,35,up,768,pert,121476,120708,121061,120515,120787,121441,689,79
2021.05.14,79,654,35,Up,768,63,188,176,up,427,pert,121687,121260,121476,120708,121323,121511,364,63
2021.05.17,63,188,176,Up,427,33,706,120,up,859,pert,122339,121480,121687,121260,121513,122219,826,33
2021.05.18,33,706,120,Up,859,145,475,233,down,853,gain,122452,121599,122339,121480,122219,121744,233,620
2021.05.19,145,475,233,down,853,54,525,21,up,600,gain,122290,121690,122452,121599,121744,122269,54,546
2021.05.20,54,525,21,Up,600,196,464,128,down,788,gain,122398,121610,122290,121690,122270,121806,128,660
2021.05.21,196,464,128,down,788,54,374,150,up,578,gain,122300,121722,122398,121610,121776,122150,54,524
2021.05.24,54,374,150,Up,578,29,351,167,up,547,pert,122664,122117,122300,121722,122146,122497,518,29
2021.05.25,29,351,167,Up,547,102,569,139,down,810,gain,122630,121820,122664,122117,122491,121922,139,671
2021.05.26,102,569,139,down,810,155,28,217,up,400,gain,122151,121751,122630,121820,121906,121934,155,245
2021.05.27,155,28,217,Up,400,569,36,118,down,723,gain,122050,121327,122151,121751,121932,121896,118,605
2021.05.28,569,36,118,down,723,160,257,64,up,481,gain,122314,121833,122050,121327,121993,122250,160,321
2021.05.31,160,257,64,Up,481,8,128,289,down,425,gain,122543,122118,122314,121833,122254,122126,289,136
2021.06.01,8,128,289,down,425,457,25,140,down,622,pert,122265,121643,122543,122118,122125,122100,482,140
2021.06.02,457,25,140,down,622,82,832,46,down,960,pert,122143,121183,122265,121643,122097,121265,914,46
2021.06.03,82,832,46,down,960,220,401,194,up,815,gain,121856,121041,122143,121183,121261,121662,220,595
2021.06.04,220,401,194,Up,815,147,298,125,up,570,pert,122018,121448,121856,121041,121595,121893,423,147
2021.06.07,147,298,125,Up,570,83,165,51,down,299,gain,121942,121643,122018,121448,121891,121726,51,248
2021.06.08,83,165,51,down,299,13,65,392,up,470,gain,122179,121709,121942,121643,121722,121787,13,457
2021.06.09,13,65,392,Up,470,319,36,163,down,518,gain,121950,121432,122179,121709,121787,121751,163,355
2021.06.10,319,36,163,down,518,136,688,180,down,1004,pert,121931,120927,121950,121432,121751,121063,824,180
2021.06.11,136,688,180,down,1004,83,175,103,up,361,gain,121303,120942,121931,120927,121025,121200,83,278
2021.06.14,83,175,103,Up,361,176,74,209,up,459,pert,121473,121014,121303,120942,121190,121264,283,176
2021.06.15,176,74,209,Up,459,3,1313,92,down,1408,gain,121348,119940,121473,121014,121256,119943,92,1316
2021.06.16,3,1313,92,down,1408,151,870,125,down,1146,pert,120064,118918,121348,119940,119939,119069,1021,125
2021.06.17,151,870,125,down,1146,60,459,195,down,714,pert,119251,118537,120064,118918,119056,118597,519,195
2021.06.18,60,459,195,down,714,73,635,27,up,735,gain,119212,118477,119251,118537,118550,119185,73,662
2021.06.21,73,635,27,Up,735,357,247,112,up,716,pert,119525,118809,119212,118477,119166,119413,359,357
2021.06.22,357,247,112,Up,716,142,118,327,down,587,gain,119703,119116,119525,118809,119376,119258,327,260
2021.06.23,142,118,327,down,587,79,61,248,up,388,gain,119563,119175,119703,119116,119254,119315,79,309
2021.06.24,79,61,248,Up,388,50,55,382,up,487,pert,119752,119265,119563,119175,119315,119370,437,50
2021.06.25,50,55,382,Up,487,217,74,129,down,420,gain,119445,119025,119752,119265,119316,119242,129,291
2021.06.29,183,270,68,down,521,108,394,136,down,638,pert,119090,118452,119298,118777,118954,118560,502,136
2021.06.30,108,394,136,down,638,123,62,283,down,468,pert,118842,118374,119090,118452,118559,118497,185,283
2021.07.01,123,62,283,down,468,420,155,97,up,672,gain,118743,118071,118842,118374,118491,118646,420,252
2021.07.02,420,155,97,Up,672,61,58,171,up,290,pert,118805,118515,118743,118071,118576,118634,229,61
2021.07.05,61,58,171,Up,290,164,388,331,down,883,gain,118950,118067,118805,118515,118619,118231,331,552
2021.07.06,164,388,331,down,883,86,332,127,down,545,pert,118362,117817,118950,118067,118235,117903,418,127
2021.07.07,86,332,127,down,545,63,550,230,up,843,gain,118679,117836,118362,117817,117899,118449,63,780
2021.07.08,63,550,230,Up,843,189,334,37,up,560,pert,118811,118251,118679,117836,118440,118774,371,189
2021.07.09,189,334,37,Up,560,245,109,87,down,441,gain,118802,118361,118811,118251,118715,118606,87,354
2021.07.12,245,109,87,down,441,41,828,159,down,1028,pert,118752,117724,118802,118361,118593,117765,869,159
2021.07.13,41,828,159,down,1028,42,597,30,up,669,gain,118388,117719,118752,117724,117761,118358,42,627
2021.07.14,42,597,30,Up,669,156,231,157,down,544,gain,118506,117962,118388,117719,118349,118118,157,387
2021.07.15,156,231,157,down,544,134,63,106,down,303,pert,118224,117921,118506,117962,118118,118055,197,106
2021.07.16,134,63,106,down,303,347,67,189,down,603,pert,118243,117640,118224,117921,118054,117987,414,189
2021.07.19,347,67,189,down,603,247,175,45,down,467,pert,118025,117558,118243,117640,117980,117805,422,45
2021.07.20,247,175,45,down,467,277,150,101,up,528,gain,118047,117519,118025,117558,117796,117946,277,251
2021.07.21,277,150,101,Up,528,132,200,396,down,728,gain,118303,117575,118047,117519,117907,117707,396,332
2021.07.22,132,200,396,down,728,145,16,160,down,321,pert,117865,117544,118303,117575,117705,117689,161,160
2021.07.23,145,16,160,down,321,42,352,144,up,538,gain,118173,117635,117865,117544,117677,118029,42,496
2021.07.26,42,352,144,Up,538,329,135,246,up,710,pert,118411,117701,118173,117635,118030,118165,381,329
2021.07.27,329,135,246,Up,710,438,282,53,up,773,pert,118494,117721,118411,117701,118159,118441,335,438
2021.07.28,438,282,53,Up,773,29,434,62,up,525,pert,118927,118402,118494,117721,118431,118865,496,29
2021.07.29,29,434,62,Up,525,213,128,229,down,570,gain,119087,118517,118927,118402,118858,118730,229,341
2021.07.30,213,128,229,down,570,51,47,281,up,379,gain,118969,118590,119087,118517,118641,118688,51,328
2021.08.02,51,47,281,Up,379,100,33,263,down,396,gain,118933,118537,118969,118590,118670,118637,263,133
2021.08.03,100,33,263,down,396,39,264,366,down,669,pert,118997,118328,118933,118537,118631,118367,303,366
2021.08.04,39,264,366,down,669,45,33,212,down,290,pert,118572,118282,118997,118328,118360,118327,78,212
2021.08.05,45,33,212,down,290,67,713,33,down,813,pert,118357,117544,118572,118282,118324,117611,780,33
2021.08.06,67,713,33,down,813,13,206,122,down,341,pert,117690,117349,118357,117544,117568,117362,219,122
2021.08.09,13,206,122,down,341,105,155,71,down,331,pert,117429,117098,117690,117349,117358,117203,260,71
2021.08.10,105,155,71,down,331,123,204,152,up,479,gain,117540,117061,117429,117098,117184,117388,123,356
2021.08.11,123,204,152,Up,479,59,84,102,down,245,gain,117482,117237,117540,117061,117380,117296,102,143
2021.08.12,59,84,102,down,245,9,672,86,up,767,gain,118048,117281,117482,117237,117290,117962,9,758
2021.08.13,9,672,86,Up,767,93,173,66,down,332,gain,118007,117675,118048,117281,117941,117768,66,266
2021.08.16,93,173,66,down,332,0,681,83,down,764,pert,117845,117081,118007,117675,117762,117081,681,83
2021.08.17,0,681,83,down,764,151,20,317,up,488,gain,117425,116937,117845,117081,117088,117108,151,337
2021.08.18,151,20,317,Up,488,99,331,89,down,519,gain,117176,116657,117425,116937,117087,116756,89,430
2021.08.19,99,331,89,down,519,112,244,49,up,405,gain,117045,116640,117176,116657,116752,116996,112,293
2021.08.20,112,244,49,Up,405,0,560,46,up,606,pert,117503,116897,117045,116640,116897,117457,606,0
2021.08.23,0,560,46,Up,606,176,106,95,up,377,pert,117650,117273,117503,116897,117449,117555,201,176
2021.08.24,176,106,95,Up,377,277,179,27,up,483,pert,117743,117260,117650,117273,117537,117716,206,277
2021.08.25,277,179,27,Up,483,56,191,84,down,331,gain,117790,117459,117743,117260,117706,117515,84,247
2021.08.26,56,191,84,down,331,165,441,71,up,677,gain,118026,117349,117790,117459,117514,117955,165,512
2021.08.27,165,441,71,Up,677,97,36,137,up,270,pert,118099,117829,118026,117349,117926,117962,173,97
2021.08.30,97,36,137,Up,270,22,122,367,up,511,pert,118450,117939,118099,117829,117961,118083,489,22
2021.08.31,22,122,367,Up,511,142,306,188,up,636,pert,118572,117936,118450,117939,118078,118384,494,142
2021.09.01,142,306,188,Up,636,30,370,15,up,415,pert,118759,118344,118572,117936,118374,118744,385,30
2021.09.02,30,370,15,Up,415,82,33,319,up,434,pert,119091,118657,118759,118344,118739,118772,352,82
2021.09.03,82,33,319,Up,434,144,67,94,down,305,gain,118862,118557,119091,118657,118768,118701,94,211
2021.09.06,144,67,94,down,305,29,273,177,down,479,pert,118852,118373,118862,118557,118675,118402,302,177
2021.09.07,29,273,177,down,479,128,206,156,down,490,pert,118512,118022,118852,118373,118356,118150,334,156
2021.09.08,128,206,156,down,490,72,119,169,up,360,gain,118413,118053,118512,118022,118125,118244,72,288
2021.09.09,72,119,169,Up,360,16,122,281,down,419,gain,118510,118091,118413,118053,118229,118107,281,138
2021.09.10,16,122,281,down,419,401,40,28,down,469,pert,118171,117702,118510,118091,118143,118103,441,28
2021.09.13,401,40,28,down,469,24,67,368,down,459,pert,118460,118001,118171,117702,118092,118025,91,368
2021.09.14,24,67,368,down,459,22,152,154,up,328,gain,118319,117991,118460,118001,118013,118165,22,306
2021.09.15,22,152,154,Up,328,146,501,53,down,700,gain,118206,117506,118319,117991,118153,117652,53,647
2021.09.16,146,501,53,down,700,8,425,213,down,646,pert,117888,117242,118206,117506,117675,117250,433,213
2021.09.17,8,425,213,down,646,253,15,91,down,359,pert,117363,117004,117888,117242,117272,117257,268,91
2021.09.20,253,15,91,down,359,99,4,234,up,337,gain,117486,117149,117363,117004,117248,117252,99,238
2021.09.21,99,4,234,Up,337,23,374,315,down,712,gain,117555,116843,117486,117149,117240,116866,315,397
2021.09.22,23,374,315,down,712,25,521,120,up,666,gain,117501,116835,117555,116843,116860,117381,25,641
2021.09.23,25,521,120,Up,666,199,173,97,down,469,gain,117476,117007,117501,116835,117379,117206,97,372
2021.09.24,199,173,97,down,469,104,303,0,down,407,pert,117255,116848,117476,117007,117255,116952,407,0
2021.09.27,104,303,0,down,407,144,114,92,down,350,pert,117032,116682,117255,116848,116940,116826,258,92
2021.09.28,144,114,92,down,350,75,856,76,down,1007,pert,116901,115894,117032,116682,116825,115969,931,76
2021.09.29,75,856,76,down,1007,143,194,134,down,471,pert,116097,115626,116901,115894,115963,115769,337,134
2021.09.30,143,194,134,down,471,110,187,148,up,445,gain,116075,115630,116097,115626,115740,115927,110,335
2021.10.01,110,187,148,Up,445,46,271,207,up,524,pert,116400,115876,116075,115630,115922,116193,478,46
2021.10.04,46,271,207,Up,524,166,212,32,down,410,gain,116216,115806,116400,115876,116184,115972,32,378
2021.10.05,166,212,32,down,410,264,403,60,down,727,pert,116019,115292,116216,115806,115959,115556,667,60
2021.10.06,264,403,60,down,727,53,11,185,down,249,pert,115723,115474,116019,115292,115538,115527,64,185
2021.10.07,53,11,185,down,249,112,210,125,up,447,gain,115861,115414,115723,115474,115526,115736,112,335
2021.10.08,112,210,125,Up,447,30,142,208,down,380,gain,115867,115487,115861,115414,115659,115517,208,172
2021.10.11,30,142,208,down,380,53,227,180,down,460,pert,115702,115242,115867,115487,115522,115295,280,180
2021.10.12,53,227,180,down,460,44,646,33,up,723,gain,115973,115250,115702,115242,115294,115940,44,679
2021.10.13,44,646,33,Up,723,65,56,286,up,407,pert,116245,115838,115973,115250,115903,115959,342,65
2021.10.14,65,56,286,Up,407,67,34,205,up,306,pert,116186,115880,116245,115838,115947,115981,239,67
2021.10.15,67,34,205,Up,306,259,121,127,up,507,pert,116224,115717,116186,115880,115976,116097,248,259
2021.10.18,259,121,127,Up,507,14,237,367,up,618,pert,116692,116074,116224,115717,116088,116325,604,14
2021.10.19,14,237,367,Up,618,134,201,81,up,416,pert,116586,116170,116692,116074,116304,116505,282,134
2021.10.20,134,201,81,Up,416,48,238,197,down,483,gain,116675,116192,116586,116170,116478,116240,197,286
2021.10.21,48,238,197,down,483,3,240,117,up,360,gain,116554,116194,116675,116192,116197,116437,3,357
2021.10.22,3,240,117,Up,360,174,299,270,down,743,gain,116650,115907,116554,116194,116380,116081,270,473
2021.10.25,174,299,270,down,743,107,119,181,down,407,pert,116257,115850,116650,115907,116076,115957,226,181
2021.10.26,107,119,181,down,407,107,71,231,up,409,gain,116257,115848,116257,115850,115955,116026,107,302
2021.10.27,107,71,231,Up,409,199,778,119,up,1096,pert,116920,115824,116257,115848,116023,116801,897,199
2021.10.28,199,778,119,Up,1096,267,1161,120,down,1548,gain,116901,115353,116920,115824,116781,115620,120,1428
2021.10.29,267,1161,120,down,1548,166,415,49,up,630,gain,116090,115460,116901,115353,115626,116041,166,464
2021.11.01,166,415,49,Up,630,33,248,104,down,385,gain,116132,115747,116090,115460,116028,115780,104,281
2021.11.02,33,248,104,down,385,149,361,30,up,540,gain,116161,115621,116132,115747,115770,116131,149,391
2021.11.03,149,361,30,Up,540,255,571,52,down,878,gain,116162,115284,116161,115621,116110,115539,52,826
2021.11.04,255,571,52,down,878,403,128,65,up,596,gain,115730,115134,116162,115284,115537,115665,403,193
2021.11.05,403,128,65,Up,596,94,267,86,up,447,pert,115950,115503,115730,115134,115597,115864,353,94
2021.11.08,94,267,86,Up,447,143,89,157,up,389,pert,116086,115697,115950,115503,115840,115929,246,143
2021.11.09,143,89,157,Up,389,27,1125,45,down,1197,gain,115953,114756,116086,115697,115908,114783,45,1152
2021.11.10,27,1125,45,down,1197,66,279,102,down,447,pert,114876,114429,115953,114756,114774,114495,345,102
2021.11.11,66,279,102,down,447,99,57,139,down,295,pert,114623,114328,114876,114429,114484,114427,156,139
2021.11.12,99,57,139,down,295,110,784,185,down,1079,pert,114641,113562,114623,114328,114456,113672,894,185
2021.11.15,110,784,185,down,1079,106,472,189,down,767,pert,113855,113088,114641,113562,113666,113194,578,189
2021.11.16,106,472,189,down,767,552,3,137,up,692,gain,113324,112632,113855,113088,113184,113187,552,140
2021.11.17,552,3,137,Up,692,39,527,37,up,603,pert,113741,113138,113324,112632,113177,113704,564,39
2021.11.18,39,527,37,Up,603,331,857,38,down,1226,gain,113724,112498,113741,113138,113686,112829,38,1188
2021.11.19,331,857,38,down,1226,57,520,17,down,594,pert,112901,112307,113724,112498,112884,112364,577,17
2021.11.22,57,520,17,down,594,102,112,276,up,490,gain,112750,112260,112901,112307,112362,112474,102,388
2021.11.23,102,112,276,Up,490,121,479,93,down,693,gain,112554,111861,112750,112260,112461,111982,93,600
2021.11.24,121,479,93,down,693,6,123,216,up,345,gain,112299,111954,112554,111861,111960,112083,6,339
2021.11.25,6,123,216,Up,345,16,1155,88,up,1259,pert,113303,112044,112299,111954,112060,113215,1243,16
2021.11.26,16,1155,88,Up,1259,318,100,110,down,528,gain,113112,112584,113303,112044,113002,112902,110,418
2021.11.29,318,100,110,down,528,529,497,450,up,1476,gain,113830,112354,113112,112584,112883,113380,529,947
2021.11.30,529,497,450,Up,1476,168,157,247,down,572,gain,113597,113025,113830,112354,113350,113193,247,325
2021.12.01,168,157,247,down,572,54,170,302,down,526,pert,113478,112952,113597,113025,113176,113006,224,302
2021.12.02,54,170,302,down,526,330,87,252,up,669,gain,113335,112666,113478,112952,112996,113083,330,339
2021.12.03,330,87,252,Up,669,182,148,109,down,439,gain,113104,112665,113335,112666,112995,112847,109,330
2021.12.06,182,148,109,down,439,397,150,162,down,709,pert,112983,112274,113104,112665,112821,112671,547,162
2021.12.07,397,150,162,down,709,25,759,132,up,916,gain,113549,112633,112983,112274,112658,113417,25,891
2021.12.08,25,759,132,Up,916,140,494,31,down,665,gain,113449,112784,113549,112633,113418,112924,31,634
2021.12.09,140,494,31,down,665,270,243,81,up,594,gain,113243,112649,113449,112784,112919,113162,270,324
2021.12.10,270,243,81,Up,594,243,235,113,down,591,gain,113190,112599,113243,112649,113077,112842,113,478
2021.12.13,243,235,113,down,591,46,224,430,down,700,pert,113237,112537,113190,112599,112807,112583,270,430
2021.12.14,46,224,430,down,700,358,344,73,up,775,gain,112992,112217,113237,112537,112575,112919,358,417
2021.12.15,358,344,73,Up,775,94,391,306,up,791,pert,113602,112811,112992,112217,112905,113296,697,94
2021.12.16,94,391,306,Up,791,28,924,193,down,1145,gain,113489,112344,113602,112811,113296,112372,193,952
2021.12.17,28,924,193,down,1145,15,413,271,up,699,gain,113040,112341,113489,112344,112356,112769,15,684
2021.12.20,15,413,271,Up,699,134,79,205,up,418,pert,113027,112609,113040,112341,112743,112822,284,134
2021.12.21,134,79,205,Up,418,178,438,165,up,781,pert,113423,112642,113027,112609,112820,113258,603,178
2021.12.22,178,438,165,Up,781,344,17,159,up,520,pert,113422,112902,113423,112642,113246,113263,176,344
2021.12.23,344,17,159,Up,520,153,63,175,down,391,gain,113435,113044,113422,112902,113260,113197,175,216
2021.12.24,153,63,175,down,391,0,241,78,up,319,gain,113342,113023,113435,113044,113023,113264,0,319
2021.12.27,0,241,78,Up,319,185,181,70,down,436,gain,113330,112894,113342,113023,113260,113079,70,366
2021.12.28,185,181,70,down,436,347,398,210,up,955,gain,113687,112732,113330,112894,113079,113477,347,608
2021.12.30,268,189,154,down,611,211,511,106,up,828,gain,113861,113033,113599,112988,113244,113755,211,617
2021.12.31,211,511,106,Up,828,176,722,85,down,983,gain,113778,112795,113861,113033,113693,112971,85,898
2022.01.03,176,722,85,down,983,139,99,265,down,503,pert,113226,112723,113778,112795,112961,112862,238,265
2022.01.04,139,99,265,down,503,87,283,331,up,701,gain,113466,112765,113226,112723,112852,113135,87,614
2022.01.05,87,283,331,Up,701,130,135,205,down,470,gain,113316,112846,113466,112765,113111,112976,205,265
2022.01.06,130,135,205,down,470,59,630,57,up,746,gain,113647,112901,113316,112846,112960,113590,59,687
2022.01.07,59,630,57,Up,746,399,298,49,down,746,gain,113599,112853,113647,112901,113550,113252,49,697
2022.01.10,399,298,49,down,746,99,436,87,up,622,gain,113753,113131,113599,112853,113230,113666,99,523
2022.01.11,99,436,87,Up,622,110,756,117,up,983,pert,114528,113545,113753,113131,113655,114411,873,110
2022.01.12,110,756,117,Up,983,45,137,278,up,460,pert,114817,114357,114528,113545,114402,114539,415,45
2022.01.13,45,137,278,Up,460,164,380,298,down,842,gain,114829,113987,114817,114357,114531,114151,298,544
2022.01.14,164,380,298,down,842,147,55,225,down,427,pert,114342,113915,114829,113987,114117,114062,202,225
2022.01.17,147,55,225,down,427,111,804,154,down,1069,pert,114216,113147,114342,113915,114062,113258,915,154
2022.01.18,111,804,154,down,1069,86,171,149,up,406,gain,113569,113163,114216,113147,113249,113420,86,320
2022.01.19,86,171,149,Up,406,77,285,296,down,658,gain,113689,113031,113569,113163,113393,113108,296,362
2022.01.20,77,285,296,down,658,82,329,176,up,587,gain,113597,113010,113689,113031,113092,113421,82,505
2022.01.21,82,329,176,Up,587,348,117,76,down,541,gain,113447,112906,113597,113010,113371,113254,76,465
2022.01.24,348,117,76,down,541,374,220,54,down,648,pert,113280,112632,113447,112906,113226,113006,594,54
2022.01.25,374,220,54,down,648,51,586,117,down,754,pert,113108,112354,113280,112632,112991,112405,637,117
2022.01.26,51,586,117,down,754,131,960,27,down,1118,pert,112431,111313,113108,112354,112404,111444,1091,27
2022.01.27,131,960,27,down,1118,214,41,268,up,523,gain,111737,111214,112431,111313,111428,111469,214,309
2022.01.28,214,41,268,Up,523,28,927,144,up,1099,pert,112477,111378,111737,111214,111406,112333,1071,28
2022.01.31,28,927,144,Up,1099,107,403,68,up,578,pert,112786,112208,112477,111378,112315,112718,471,107
2022.02.01,107,403,68,Up,578,48,320,266,up,634,pert,113301,112667,112786,112208,112715,113035,586,48
2022.02.02,48,320,266,Up,634,353,1374,121,up,1848,pert,114513,112665,113301,112667,113018,114392,1495,353
2022.02.03,353,1374,121,Up,1848,273,125,322,up,720,pert,114836,114116,114513,112665,114389,114514,447,273
2022.02.04,273,125,322,Up,720,268,154,41,down,463,gain,114614,114151,114836,114116,114573,114419,41,422
2022.02.07,268,154,41,down,463,205,248,75,down,528,pert,114486,113958,114614,114151,114411,114163,453,75
2022.02.08,205,248,75,down,528,102,106,246,up,454,gain,114479,114025,114486,113958,114127,114233,102,352
2022.02.09,102,106,246,Up,454,462,65,675,up,1202,pert,114950,113748,114479,114025,114210,114275,740,462
2022.02.10,462,65,675,Up,1202,180,786,28,down,994,gain,114291,113297,114950,113748,114263,113477,28,966
2022.02.11,180,786,28,down,994,258,318,312,down,888,pert,113688,112800,114291,113297,113376,113058,576,312
2022.02.14,258,318,312,down,888,42,550,101,up,693,gain,113683,112990,113688,112800,113032,113582,42,651
2022.02.15,42,550,101,Up,693,120,154,233,up,507,pert,113955,113448,113683,112990,113568,113722,387,120
2022.02.16,120,154,233,Up,507,379,105,144,down,628,gain,113857,113229,113955,113448,113713,113608,144,484
2022.02.17,379,105,144,down,628,88,353,189,down,630,pert,113769,113139,113857,113229,113580,113227,441,189
2022.02.18,88,353,189,down,630,29,52,762,down,843,pert,113907,113064,113769,113139,113145,113093,81,762
2022.02.21,29,52,762,down,843,192,171,429,up,792,gain,113670,112878,113907,113064,113070,113241,192,600
2022.02.22,192,171,429,Up,792,39,195,342,down,576,gain,113588,113012,113670,112878,113246,113051,342,234
2022.02.23,39,195,342,down,576,856,1104,63,down,2023,pert,113086,111063,113588,113012,113023,111919,1960,63
2022.02.24,856,1104,63,down,2023,249,808,19,up,1076,gain,112735,111659,113086,111063,111908,112716,249,827
2022.02.25,249,808,19,Up,1076,50,883,286,up,1219,pert,112464,111245,112735,111659,111295,112178,1169,50
2022.02.28,50,883,286,Up,1219,332,948,154,down,1434,gain,112331,110897,112464,111245,112177,111229,154,1280
2022.03.01,332,948,154,down,1434,610,64,186,down,860,pert,111434,110574,112331,110897,111248,111184,674,186
2022.03.02,610,64,186,down,860,327,501,45,down,873,pert,111205,110332,111434,110574,111160,110659,828,45
2022.03.03,327,501,45,down,873,453,1346,28,down,1827,pert,110679,108852,111205,110332,110651,109305,1799,28
2022.03.04,453,1346,28,down,1827,473,722,69,down,1264,pert,109324,108060,110679,108852,109255,108533,1195,69
2022.03.07,473,722,69,down,1264,40,503,569,up,1112,gain,109583,108471,109324,108060,108511,109014,40,1072
2022.03.08,40,503,569,Up,1112,64,1790,211,up,2065,pert,110961,108896,109583,108471,108960,110750,2001,64
2022.03.09,64,1790,211,Up,2065,101,870,484,down,1455,gain,111213,109758,110961,108896,110729,109859,484,971
2022.03.10,101,870,484,down,1455,116,708,589,down,1413,pert,110434,109021,111213,109758,109845,109137,824,589
2022.03.11,116,708,589,down,1413,151,292,491,up,934,gain,109938,109004,110434,109021,109155,109447,151,783
2022.03.14,151,292,491,Up,934,156,73,711,up,940,pert,110200,109260,109938,109004,109416,109489,784,156
2022.03.15,156,73,711,Up,940,0,819,160,up,979,pert,110470,109491,110200,109260,109491,110310,979,0
2022.03.16,0,819,160,Up,979,234,596,475,up,1305,pert,111376,110071,110470,109491,110305,110901,1071,234
2022.03.17,234,596,475,Up,1305,472,387,296,down,1155,gain,111186,110031,111376,110071,110890,110503,296,859
2022.03.18,472,387,296,down,1155,86,316,198,down,600,pert,110702,110102,111186,110031,110504,110188,402,198
2022.03.21,86,316,198,down,600,566,118,164,up,848,gain,110458,109610,110702,110102,110176,110294,566,282
2022.03.22,566,118,164,Up,848,425,213,148,down,786,gain,110427,109641,110458,109610,110279,110066,148,638
2022.03.23,425,213,148,down,786,324,70,83,down,477,pert,110135,109658,110427,109641,110052,109982,394,83
2022.03.24,324,70,83,down,477,45,105,421,down,571,pert,110380,109809,110135,109658,109959,109854,150,421
2022.03.25,45,105,421,down,571,395,17,138,up,550,gain,109997,109447,110380,109809,109842,109859,395,155
2022.03.28,395,17,138,Up,550,144,1024,513,up,1681,pert,111371,109690,109997,109447,109834,110858,1537,144
2022.03.29,144,1024,513,Up,1681,59,724,135,up,918,pert,111710,110792,111371,109690,110851,111575,859,59
2022.03.30,59,724,135,Up,918,52,914,269,down,1235,gain,111848,110613,111710,110792,111579,110665,269,966
2022.03.31,52,914,269,down,1235,164,209,101,down,474,pert,110757,110283,111848,110613,110656,110447,373,101
2022.04.01,164,209,101,down,474,107,621,207,down,935,pert,110543,109608,110757,110283,110336,109715,728,207
2022.04.04,107,621,207,down,935,41,647,198,down,886,pert,109886,109000,110543,109608,109688,109041,688,198
2022.04.05,41,647,198,down,886,215,73,352,down,640,pert,109381,108741,109886,109000,109029,108956,288,352
2022.04.06,215,73,352,down,640,128,179,426,down,733,pert,109382,108649,109381,108741,108956,108777,307,426
2022.04.07,128,179,426,down,733,383,17,157,down,557,pert,108921,108364,109382,108649,108764,108747,400,157
2022.04.08,383,17,157,down,557,100,330,174,down,604,pert,109333,108729,108921,108364,109159,108829,430,174
2022.04.11,100,330,174,down,604,53,556,210,down,819,pert,109035,108216,109333,108729,108825,108269,609,210
2022.04.12,53,556,210,down,819,166,646,40,up,852,gain,108942,108090,109035,108216,108256,108902,166,686
2022.04.13,166,646,40,Up,852,710,611,336,down,1657,gain,109233,107576,108942,108090,108897,108286,336,1321
2022.04.14,710,611,336,down,1657,152,165,25,down,342,pert,108303,107961,109233,107576,108278,108113,317,25
2022.04.15,152,165,25,down,342,108,184,219,down,511,pert,108213,107702,108303,107961,107994,107810,292,219
2022.04.18,108,184,219,down,511,193,72,264,up,529,gain,108141,107612,108213,107702,107805,107877,193,336
2022.04.19,193,72,264,Up,529,49,663,128,up,840,pert,108667,107827,108141,107612,107876,108539,791,49
2022.04.20,49,663,128,Up,840,97,160,868,down,1125,gain,109364,108239,108667,107827,108496,108336,868,257
2022.04.21,97,160,868,down,1125,302,359,151,down,812,pert,108519,107707,109364,108239,108368,108009,661,151
2022.04.22,302,359,151,down,812,160,946,74,down,1180,pert,108145,106965,108519,107707,108071,107125,1106,74
2022.04.25,160,946,74,down,1180,19,734,282,down,1035,pert,107388,106353,108145,106965,107106,106372,753,282
2022.04.26,19,734,282,down,1035,429,790,184,down,1403,pert,106547,105144,107388,106353,106363,105573,1219,184
2022.04.27,429,790,184,down,1403,274,588,75,down,937,pert,105646,104709,106547,105144,105571,104983,862,75
2022.04.28,274,588,75,down,937,70,484,467,up,1021,gain,105927,104906,105646,104709,104976,105460,70,951
2022.04.29,70,484,467,Up,1021,170,349,260,down,779,gain,105681,104902,105927,104906,105421,105072,260,519
2022.05.02,170,349,260,down,779,148,132,573,up,853,gain,105775,104922,105681,104902,105070,105202,148,705
2022.05.03,148,132,573,Up,853,126,1033,87,up,1246,pert,106306,105060,105775,104922,105186,106219,1120,126
2022.05.04,126,1033,87,Up,1246,482,786,223,down,1491,gain,106419,104928,106306,105060,106196,105410,223,1268
2022.05.05,482,786,223,down,1491,585,26,548,up,1159,gain,105987,104828,106419,104928,105413,105439,585,574
2022.05.06,585,26,548,Up,1159,433,183,355,up,971,pert,105925,104954,105987,104828,105387,105570,538,433
2022.05.09,433,183,355,Up,971,24,289,281,down,594,gain,105851,105257,105925,104954,105570,105281,281,313
2022.05.10,24,289,281,down,594,75,189,489,down,753,pert,105770,105017,105851,105257,105281,105092,264,489
2022.05.11,75,189,489,down,753,239,1313,199,down,1751,pert,105291,103540,105770,105017,105092,103779,1552,199
2022.05.12,239,1313,199,down,1751,285,298,119,up,702,gain,104196,103494,105291,103540,103779,104077,285,417
2022.05.13,285,298,119,Up,702,72,352,119,up,543,pert,104430,103887,104196,103494,103959,104311,471,72
2022.05.16,72,352,119,Up,543,34,1155,95,up,1284,pert,105560,104276,104430,103887,104310,105465,1250,34
2022.05.17,34,1155,95,Up,1284,10,856,174,down,1040,gain,105639,104599,105560,104276,105465,104609,174,866
2022.05.18,10,856,174,down,1040,19,1245,219,up,1483,gain,106073,104590,105639,104599,104609,105854,19,1464
2022.05.19,19,1245,219,Up,1483,254,234,174,down,662,gain,105990,105328,106073,104590,105816,105582,174,488
2022.05.20,254,234,174,down,662,40,1280,94,up,1414,gain,106975,105561,105990,105328,105601,106881,40,1374
2022.05.23,40,1280,94,Up,1414,267,455,156,up,878,pert,107489,106611,106975,105561,106878,107333,611,267
2022.05.24,267,455,156,Up,878,372,539,53,down,964,gain,107382,106418,107489,106611,107329,106790,53,911
2022.05.25,372,539,53,down,964,148,464,71,up,683,gain,107310,106627,107382,106418,106775,107239,148,535
2022.05.26,148,464,71,Up,683,265,70,342,up,677,pert,107651,106974,107310,106627,107239,107309,412,265
2022.05.27,265,70,342,Up,677,83,454,89,up,626,pert,107869,107243,107651,106974,107326,107780,543,83
2022.05.30,83,454,89,Up,626,535,430,32,down,997,gain,107788,106791,107869,107243,107756,107326,32,965
2022.05.31,535,430,32,down,997,212,836,70,down,1118,pert,107390,106272,107788,106791,107320,106484,1048,70
2022.06.01,212,836,70,down,1118,48,1010,36,up,1094,gain,107499,106405,107390,106272,106453,107463,48,1046
2022.06.02,48,1010,36,Up,1094,126,278,195,down,599,gain,107638,107039,107499,106405,107443,107165,195,404
2022.06.03,126,278,195,down,599,114,191,370,down,675,pert,107516,106841,107638,107039,107146,106955,305,370
2022.06.06,114,191,370,down,675,427,99,94,up,620,gain,107143,106523,107516,106841,106950,107049,427,193
2022.06.07,427,99,94,Up,620,321,121,328,up,770,pert,107485,106715,107143,106523,107036,107157,449,321
2022.06.08,321,121,328,Up,770,52,995,585,down,1632,gain,107739,106107,107485,106715,107154,106159,585,1047
2022.06.09,52,995,585,down,1632,147,935,282,down,1364,pert,106424,105060,107739,106107,106142,105207,1082,282
2022.06.10,147,935,282,down,1364,80,1061,58,down,1199,pert,105195,103996,106424,105060,105137,104076,1141,58
2022.06.13,80,1061,58,down,1199,109,73,697,up,879,gain,104848,103969,105195,103996,104078,104151,109,770
2022.06.14,109,73,697,Up,879,549,290,646,up,1485,pert,105076,103591,104848,103969,104140,104430,936,549
2022.06.15,549,290,646,Up,1485,601,1071,526,up,2198,pert,106009,103811,105076,103591,104412,105483,1597,601
2022.06.16,601,1071,526,Up,2198,515,492,148,down,1155,gain,105602,104447,106009,103811,105454,104962,148,1007
2022.06.17,515,492,148,down,1155,20,357,353,up,730,gain,105457,104727,105602,104447,104747,105104,20,710
2022.06.20,20,357,353,Up,730,51,214,506,up,771,pert,105824,105053,105457,104727,105104,105318,720,51
2022.06.21,51,214,506,Up,771,608,379,376,up,1363,pert,106054,104691,105824,105053,105299,105678,755,608
2022.06.22,608,379,376,Up,1363,388,416,181,down,985,gain,105812,104827,106054,104691,105631,105215,181,804
2022.06.23,388,416,181,down,985,106,309,177,up,592,gain,105711,105119,105812,104827,105225,105534,106,486
2022.06.24,106,309,177,Up,592,0,373,320,up,693,pert,106149,105456,105711,105119,105456,105829,693,0
2022.06.27,0,373,320,Up,693,147,637,241,down,1025,gain,106058,105033,106149,105456,105817,105180,241,784
2022.06.29,59,759,183,down,1001,571,433,64,up,1068,gain,104891,103823,105353,104352,104394,104827,571,497
2022.06.30,571,433,64,Up,1068,604,565,28,down,1197,gain,104854,103657,104891,103823,104826,104261,28,1169
2022.07.01,604,565,28,down,1197,0,75,406,up,481,gain,104627,104146,104854,103657,104146,104221,0,481
2022.07.04,0,75,406,Up,481,307,1542,290,down,2139,gain,104488,102349,104627,104146,104198,102656,290,1849
2022.07.05,307,1542,290,down,2139,192,831,128,down,1151,pert,102769,101618,104488,102349,102641,101810,1023,128
2022.07.06,192,831,128,down,1151,146,210,416,down,772,pert,102213,101441,102769,101618,101797,101587,356,416
2022.07.07,146,210,416,down,772,847,267,81,up,1195,gain,101912,100717,102213,101441,101564,101831,847,348
2022.07.08,847,267,81,Up,1195,59,1300,135,down,1494,gain,101831,100337,101912,100717,101696,100396,135,1359
2022.07.11,59,1300,135,down,1494,369,31,343,down,743,pert,100739,99996,101831,100337,100396,100365,400,343
2022.07.12,369,31,343,down,743,369,228,648,up,1245,gain,101222,99977,100739,99996,100346,100574,369,876
2022.07.13,369,228,648,Up,1245,656,373,47,down,1076,gain,100598,99522,101222,99977,100551,100178,47,1029
2022.07.14,656,373,47,down,1076,84,700,127,up,911,gain,100981,100070,100598,99522,100154,100854,84,827
2022.07.15,84,700,127,Up,911,82,602,596,up,1280,pert,102014,100734,100981,100070,100816,101418,1198,82
2022.07.18,82,602,596,Up,1280,215,839,447,up,1501,pert,102694,101193,102014,100734,101408,102247,1286,215
2022.07.19,215,839,447,Up,1501,251,442,484,down,1177,gain,102729,101552,102694,101193,102245,101803,484,693
2022.07.20,251,442,484,down,1177,231,534,483,up,1248,gain,102783,101535,102729,101552,101766,102300,231,1017
2022.07.21,231,534,483,Up,1248,810,173,271,down,1254,gain,102553,101299,102783,101535,102282,102109,271,983
2022.07.22,810,173,271,down,1254,331,72,392,up,795,gain,102580,101785,102553,101299,102116,102188,331,464
2022.07.25,331,72,392,Up,795,78,1030,317,down,1425,gain,102502,101077,102580,101785,102185,101155,317,1108
2022.07.26,78,1030,317,down,1425,170,841,235,up,1246,gain,102210,100964,102502,101077,101134,101975,170,1076
2022.07.27,170,841,235,Up,1246,821,40,341,down,1202,gain,102344,101142,102210,100964,102003,101963,341,861
2022.07.28,821,40,341,down,1202,495,302,284,up,1081,gain,102542,101461,102344,101142,101956,102258,495,586
2022.07.29,495,302,284,Up,1081,23,542,135,up,700,pert,102752,102052,102542,101461,102075,102617,677,23
2022.08.01,23,542,135,Up,700,25,948,333,down,1306,gain,102936,101630,102752,102052,102603,101655,333,973
2022.08.02,25,948,333,down,1306,424,8,443,up,875,gain,102104,101229,102936,101630,101653,101661,424,451
2022.08.03,424,8,443,Up,875,133,775,92,up,1000,pert,102539,101539,102104,101229,101672,102447,867,133
2022.08.04,133,775,92,Up,1000,360,661,81,down,1102,gain,102518,101416,102539,101539,102437,101776,81,1021
2022.08.05,360,661,81,down,1102,117,232,276,up,625,gain,102219,101594,102518,101416,101711,101943,117,508
2022.08.08,117,232,276,Up,625,61,181,349,up,591,pert,102475,101884,102219,101594,101945,102126,530,61
2022.08.09,61,181,349,Up,591,101,866,700,up,1667,pert,103688,102021,102475,101884,102122,102988,1566,101
2022.08.10,101,866,700,Up,1667,226,211,451,up,888,pert,103645,102757,103688,102021,102983,103194,662,226
2022.08.11,226,211,451,Up,888,175,614,99,down,888,gain,103273,102385,103645,102757,103174,102560,99,789
2022.08.12,175,614,99,down,888,52,949,139,down,1140,pert,102684,101544,103273,102385,102545,101596,1001,139
2022.08.15,52,949,139,down,1140,355,123,247,up,725,gain,101949,101224,102684,101544,101579,101702,355,370
2022.08.16,355,123,247,Up,725,241,109,224,up,574,pert,102031,101457,101949,101224,101698,101807,333,241
2022.08.17,241,109,224,Up,574,83,901,154,down,1138,gain,101930,100792,102031,101457,101776,100875,154,984
2022.08.18,83,901,154,down,1138,72,473,89,down,634,pert,100955,100321,101930,100792,100866,100393,545,89
2022.08.19,72,473,89,down,634,167,918,118,down,1203,pert,100466,99263,100955,100321,100348,99430,1085,118
2022.08.22,167,918,118,down,1203,419,272,484,up,1175,gain,100179,99004,100466,99263,99423,99695,419,756
2022.08.23,419,272,484,Up,1175,561,20,308,down,889,gain,99990,99101,100179,99004,99682,99662,308,581
2022.08.24,561,20,308,down,889,149,103,591,up,843,gain,100334,99491,99990,99101,99640,99743,149,694
2022.08.25,149,103,591,Up,843,181,78,1177,down,1436,gain,100901,99465,100334,99491,99724,99646,1177,259
2022.08.26,181,78,1177,down,1436,502,327,321,up,1150,gain,100293,99143,100901,99465,99645,99972,502,648
2022.08.29,502,327,321,Up,1150,107,210,412,up,729,pert,100549,99820,100293,99143,99927,100137,622,107
2022.08.30,107,210,412,Up,729,408,423,245,up,1076,pert,100790,99714,100549,99820,100122,100545,668,408
2022.08.31,408,423,245,Up,1076,332,1068,35,down,1435,gain,100545,99110,100790,99714,100510,99442,35,1400
2022.09.01,332,1068,35,down,1435,38,129,767,up,934,gain,100338,99404,100545,99110,99442,99571,38,896
2022.09.02,38,129,767,Up,934,504,28,133,up,665,pert,99443,98778,100338,99404,99282,99310,161,504
2022.09.05,504,28,133,Up,665,391,214,620,down,1225,gain,99865,98640,99443,98778,99245,99031,620,605
2022.09.06,391,214,620,down,1225,275,1026,50,up,1351,gain,100107,98756,99865,98640,99031,100057,275,1076
2022.09.07,275,1026,50,Up,1351,661,14,317,up,992,pert,100300,99308,100107,98756,99969,99983,331,661
2022.09.08,661,14,317,Up,992,68,472,679,up,1219,pert,101134,99915,100300,99308,99983,100455,1151,68
2022.09.09,68,472,679,Up,1219,420,194,768,up,1382,pert,101979,100597,101134,99915,101017,101211,962,420
2022.09.12,420,194,768,Up,1382,23,1521,666,down,2210,gain,101873,99663,101979,100597,101207,99686,666,1544
2022.09.13,23,1521,666,down,2210,123,140,422,up,685,gain,100236,99551,101873,99663,99674,99814,123,562
2022.09.14,123,140,422,Up,685,225,185,215,up,625,pert,100181,99556,100236,99551,99781,99966,400,225
2022.09.15,225,185,215,Up,625,531,154,238,up,923,pert,100367,99444,100181,99556,99975,100129,392,531
2022.09.16,531,154,238,Up,923,384,197,51,up,632,pert,100291,99659,100367,99444,100043,100240,248,384
2022.09.19,384,197,51,Up,632,162,486,309,down,957,gain,100506,99549,100291,99659,100197,99711,309,648
2022.09.20,162,486,309,down,957,245,1325,56,down,1626,pert,99753,98127,100506,99549,99697,98372,1570,56
2022.09.21,245,1325,56,down,1626,287,33,679,up,999,gain,99074,98075,99753,98127,98362,98395,287,712
2022.09.22,287,33,679,Up,999,202,1403,237,down,1842,gain,98520,96678,99074,98075,98283,96880,237,1605
2022.09.23,202,1403,237,down,1842,563,627,376,down,1566,pert,97090,95524,98520,96678,96714,96087,1190,376
2022.09.26,563,627,376,down,1566,233,160,627,down,1020,pert,96711,95691,97090,95524,96084,95924,393,627
2022.09.27,233,160,627,down,1020,566,1424,162,up,2152,gain,97509,95357,96711,95691,95923,97347,566,1586
2022.09.28,566,1424,162,Up,2152,960,832,4,up,1796,pert,98151,96355,97509,95357,97315,98147,836,960
2022.09.29,960,832,4,Up,1796,642,154,395,down,1191,gain,98539,97348,98151,96355,98144,97990,395,796
2022.09.30,642,154,395,down,1191,221,499,201,up,921,gain,98447,97526,98539,97348,97747,98246,221,700
2022.10.03,221,499,201,Up,921,179,1603,154,up,1936,pert,99996,98060,98447,97526,98239,99842,1757,179
2022.10.04,179,1603,154,Up,1936,407,1083,114,down,1604,gain,99949,98345,99996,98060,99835,98752,114,1490
2022.10.05,407,1083,114,down,1604,30,836,516,down,1382,pert,99263,97881,99949,98345,98747,97911,866,516
2022.10.06,30,836,516,down,1382,122,498,289,down,909,pert,98168,97259,99263,97881,97879,97381,620,289
2022.10.07,122,498,289,down,909,210,283,221,down,714,pert,97533,96819,98168,97259,97312,97029,493,221
2022.10.10,210,283,221,down,714,299,70,672,up,1041,gain,97747,96706,97533,96819,97005,97075,299,742
2022.10.11,299,70,672,Up,1041,345,27,293,down,665,gain,97343,96678,97747,96706,97050,97023,293,372
2022.10.12,345,27,293,down,665,696,764,287,up,1747,gain,98061,96314,97343,96678,97010,97774,696,1051
2022.10.13,696,764,287,Up,1747,164,483,365,down,1012,gain,98082,97070,98061,96314,97717,97234,365,647
2022.10.14,164,483,365,down,1012,8,1224,114,up,1346,gain,98522,97176,98082,97070,97184,98408,8,1338
2022.10.17,8,1224,114,Up,1346,260,189,181,up,630,pert,98757,98127,98522,97176,98387,98576,370,260
2022.10.18,260,189,181,Up,630,148,823,179,down,1150,gain,98724,97574,98757,98127,98545,97722,179,971
2022.10.19,148,823,179,down,1150,169,149,594,up,912,gain,98456,97544,98724,97574,97713,97862,169,743
2022.10.20,169,149,594,Up,912,793,783,66,up,1642,pert,98692,97050,98456,97544,97843,98626,849,793
2022.10.21,793,783,66,Up,1642,549,118,255,up,922,pert,98992,98070,98692,97050,98619,98737,373,549
2022.10.24,549,118,255,Up,922,230,932,125,up,1287,pert,99769,98482,98992,98070,98712,99644,1057,230
2022.10.26,187,1206,63,Up,1456,60,1112,187,down,1359,gain,100933,99574,100889,99433,100746,99634,187,1172
2022.10.27,60,1112,187,down,1359,366,26,324,up,716,gain,99981,99265,100933,99574,99631,99657,366,350
2022.10.28,366,26,324,Up,716,116,727,105,down,948,gain,99659,98711,99981,99265,99554,98827,105,843
2022.11.01,217,79,713,down,1009,41,572,1020,down,1633,pert,99761,98128,99540,98531,98741,98169,613,1020
2022.11.02,41,572,1020,down,1633,189,658,249,down,1096,pert,98398,97302,99761,98128,98149,97491,847,249
2022.11.03,189,658,249,down,1096,71,2102,73,up,2246,gain,99667,97421,98398,97302,97492,99594,71,2175
2022.11.04,71,2102,73,Up,2246,20,1210,124,up,1354,pert,100341,98987,99667,97421,99007,100217,1334,20
2022.11.07,20,1210,124,Up,1354,452,560,235,up,1247,pert,100964,99717,100341,98987,100169,100729,795,452
2022.11.08,452,560,235,Up,1247,193,595,167,down,955,gain,100882,99927,100964,99717,100715,100120,167,788
2022.11.09,193,595,167,down,955,739,1999,127,up,2865,gain,102220,99355,100882,99927,100094,102093,739,2126
2022.11.10,739,1999,127,Up,2865,433,1468,112,up,2013,pert,103642,101629,102220,99355,102062,103530,1580,433
2022.11.11,433,1468,112,Up,2013,546,133,195,down,874,gain,103588,102714,103642,101629,103393,103260,195,679
2022.11.14,546,133,195,down,874,455,226,1337,up,2018,gain,104819,102801,103588,102714,103256,103482,455,1563
2022.11.15,455,226,1337,Up,2018,161,475,446,up,1082,pert,104387,103305,104819,102801,103466,103941,921,161
2022.11.16,161,475,446,Up,1082,583,297,134,down,1014,gain,104067,103053,104387,103305,103933,103636,134,880
2022.11.17,583,297,134,down,1014,66,383,377,down,826,pert,103960,103134,104067,103053,103583,103200,449,377
2022.11.18,66,383,377,down,826,178,789,137,down,1104,pert,103332,102228,103960,103134,103195,102406,967,137
2022.11.21,178,789,137,down,1104,9,651,47,up,707,gain,103082,102375,103332,102228,102384,103035,9,698
2022.11.22,9,651,47,Up,707,49,929,111,up,1089,pert,104052,102963,103082,102375,103012,103941,1040,49
2022.11.23,49,929,111,Up,1089,122,173,371,up,666,pert,104485,103819,104052,102963,103941,104114,544,122
2022.11.24,122,173,371,Up,666,391,128,226,down,745,gain,104293,103548,104485,103819,104067,103939,226,519
2022.11.25,391,128,226,down,745,79,283,1305,down,1667,pert,104969,103302,104293,103548,103664,103381,362,1305
2022.11.28,79,283,1305,down,1667,88,81,573,down,742,pert,103941,103199,104969,103302,103368,103287,169,573
2022.11.29,88,81,573,down,742,377,779,233,up,1389,gain,104288,102899,103941,103199,103276,104055,377,1012
2022.11.30,377,779,233,Up,1389,150,1167,88,up,1405,pert,105335,103930,104288,102899,104080,105247,1255,150
2022.12.01,150,1167,88,Up,1405,913,213,42,up,1168,pert,105449,104281,105335,103930,105194,105407,255,913
2022.12.02,913,213,42,Up,1168,105,398,644,down,1147,gain,105950,104803,105449,104281,105306,104908,644,503
2022.12.05,105,398,644,down,1147,49,272,415,down,736,pert,105329,104593,105950,104803,104914,104642,321,415
2022.12.06,49,272,415,down,736,210,395,462,up,1067,gain,105498,104431,105329,104593,104641,105036,210,857
2022.12.07,210,395,462,Up,1067,136,492,128,up,756,pert,105651,104895,105498,104431,105031,105523,620,136
2022.12.08,136,492,128,Up,756,291,202,345,down,838,gain,105881,105043,105651,104895,105536,105334,345,493
2022.12.09,291,202,345,down,838,218,102,425,up,745,gain,105803,105058,105881,105043,105276,105378,218,527
2022.12.12,218,102,425,Up,745,71,968,415,up,1454,pert,106734,105280,105803,105058,105351,106319,1383,71
2022.12.13,71,968,415,Up,1454,129,500,132,up,761,pert,106951,106190,106734,105280,106319,106819,632,129
2022.12.14,129,500,132,Up,761,337,552,552,down,1441,gain,107363,105922,106951,106190,106811,106259,552,889
2022.12.15,337,552,552,down,1441,42,345,395,down,782,pert,106631,105849,107363,105922,106236,105891,387,395
2022.12.16,42,345,395,down,782,56,252,516,up,824,gain,106580,105756,106631,105849,105812,106064,56,768
2022.12.19,56,252,516,Up,824,243,187,369,up,799,pert,106587,105788,106580,105756,106031,106218,556,243
2022.12.20,243,187,369,Up,799,136,192,219,down,547,gain,106451,105904,106587,105788,106232,106040,219,328
2022.12.21,136,192,219,down,547,238,57,567,down,862,pert,106595,105733,106451,105904,106028,105971,295,567
2022.12.22,238,57,567,down,862,83,215,167,up,465,gain,106330,105865,106595,105733,105948,106163,83,382
2022.12.23,83,215,167,Up,465,141,70,14,up,225,pert,106366,106141,106330,105865,106282,106352,84,141
2022.12.26,141,70,14,Up,225,240,34,306,up,580,pert,106696,106116,106366,106141,106356,106390,340,240
2022.12.27,240,34,306,Up,580,52,274,355,down,681,gain,106744,106063,106696,106116,106389,106115,355,326
2022.12.28,52,274,355,down,681,36,519,294,up,849,gain,106904,106055,106744,106063,106091,106610,36,813
